TF	motif_sequence	reverse_sequence
ADNP	CTCAGTTTCCTCATCTGTAAAATGGGG	CCCCATTTTACAGATGAGGAAACTGAG
ADNP_2	CTCAGTTTCCTCATCTGTAAAATGGG	CCCATTTTACAGATGAGGAAACTGAG
ALX3	TCTAATTAAA	TTTAATTAGA
ALX3_2	TAATTA	TAATTA
ALX4::TBX21	AGGTGTTAATTA	TAATTAACACCT
AR	AAGAACAGAATGTTC	GAACATTCTGTTCTT
ARGFX	TCTAATTAAA	TTTAATTAGA
ARGFX_2	CTAATTAA	TTAATTAG
ARNT2	GTCACGTGCC	GGCACGTGAC
ARNT2_2	GTCACGTG	CACGTGAC
ARNT::HIF1A	GGACGTGC	GCACGTCC
ARNT::HIF1A_2	ACGTG	CACGT
ASCL1	GCAGCAGCTGGCG	CGCCAGCTGCTGC
ASCL1_2	GGCAGCTGCC	GGCAGCTGCC
ASCL1_3	CAGCACCTGCCCC	GGGGCAGGTGCTG
ASCL1_4	GCAGCTGC	GCAGCTGC
ASCL1_5	GCACCTGCC	GGCAGGTGC
ATF2	AAATGAGGTCATT	AATGACCTCATTT
ATF2_2	ATGAGGTCAT	ATGACCTCAT
ATF3	GATGACGTCATC	GATGACGTCATC
ATF3_2	ATGACGTCAT	ATGACGTCAT
ATF4	GGATGATGCAATA	TATTGCATCATCC
ATF4_2	AAATGATGCAATAA	TTATTGCATCATTT
ATF4_3	ATGATGCAAT	ATTGCATCAT
ATF5	TGAGTCA	TGACTCA
ATF6	TGATGACGTGGCAG	CTGCCACGTCATCA
ATF6_2	TGATGACGTGGCA	TGCCACGTCATCA
ATF6B	GATGACGTCATC	GATGACGTCATC
ATF6B_2	TGCCACGTCACC	GGTGACGTGGCA
ATF6B_3	TGCCACGTGGCA	TGCCACGTGGCA
ATF6B_4	ATGACGTCAT	ATGACGTCAT
ATF6B_5	TGCCACGTCAC	GTGACGTGGCA
ATF7	CGATGACGTCATCG	CGATGACGTCATCG
ATF7_2	ATGACGTCAT	ATGACGTCAT
ATOH1	AACAGCTGTC	GACAGCTGTT
ATOH7	AACATATGTC	GACATATGTT
BACH1	GATGACTCAGCAA	TTGCTGAGTCATC
BACH1_2	ATGACTCAT	ATGAGTCAT
BACH2	GATGACTCAGCAAT	ATTGCTGAGTCATC
BACH2_2	AAAGCATGACTCATCATTT	AAATGATGAGTCATGCTTT
BACH2_3	AAAGCATGACGTCATGATTT	AAATCATGACGTCATGCTTT
BACH2_4	CATGACTCATC	GATGAGTCATG
BACH2_5	AAAGCATGACGTCATGATT	AATCATGACGTCATGCTTT
BARHL1	CTAAACGG	CCGTTTAG
BARHL1_2	ACCGTTTA	TAAACGGT
BARHL1_3	CGTTTA	TAAACG
BARHL2	GCTAAACGGT	ACCGTTTAGC
BARHL2_2	TAAACG	CGTTTA
BARX1	GCAATTAG	CTAATTGC
BARX1_2	CAATTA	TAATTG
BARX2	AAAAACCATTAC	GTAATGGTTTTT
BARX2_2	AAACCATTA	TAATGGTTT
BATF	TATGACTCATA	TATGAGTCATA
BATF_2	TGACTCA	TGAGTCA
BATF3	TATGACTCATA	TATGAGTCATA
BATF3_2	TGACTCA	TGAGTCA
BATF::JUN	GAAATGACTCA	TGAGTCATTTC
BATF::JUN_2	TATGACTCATA	TATGAGTCATA
BATF::JUN_3	TGACTCA	TGAGTCA
BBX	TGAACGCCGTTCA	TGAACGGCGTTCA
BCL11A	CTGACCA	TGGTCAG
BCL11B	GTGAACGCTGAAGCTACAC	GTGTAGCTTCAGCGTTCAC
BCL6	ATGCTTTCGAGGAATT	AATTCCTCGAAAGCAT
BCL6_2	GCTTTCGAGGAAT	ATTCCTCGAAAGC
BCL6B	TGCTTTCTAGGAATTCA	TGAATTCCTAGAAAGCA
BHLHA15	AACAGCTGTT	AACAGCTGTT
BHLHA15_2	ACCATATGGT	ACCATATGGT
BHLHE22	ACCATATGTT	AACATATGGT
BHLHE22_2	CGCAGCTGCG	CGCAGCTGCG
BHLHE22_3	ACCATATGGT	ACCATATGGT
BHLHE22_4	CAGCTG	CAGCTG
BHLHE23	AAACATATGTTT	AAACATATGTTT
BHLHE23_2	AACATATGTT	AACATATGTT
BHLHE40	ATCACGTGAC	GTCACGTGAT
BHLHE40_2	TCACGTGA	TCACGTGA
BHLHE41	GTCACGTGAC	GTCACGTGAC
BNC2	TTGTGAGTCATA	TATGACTCACAA
BNC2_2	TGAGTCA	TGACTCA
BSX	CCAATTAA	TTAATTGG
BSX_2	CAATTA	TAATTG
CDX1	GCAATAAAA	TTTTATTGC
CDX1_2	GGCCATAAAAC	GTTTTATGGCC
CDX1_3	GGCAATAAAA	TTTTATTGCC
CDX2	AAGCCATAAAA	TTTTATGGCTT
CDX2_2	AAGCAATAAAAA	TTTTTATTGCTT
CDX2_3	GCAATAAA	TTTATTGC
CDX4	GGCAATAAAAC	GTTTTATTGCC
CDX4_2	GCAATAAAA	TTTTATTGC
CEBPA	ATTGCACAATA	TATTGTGCAAT
CEBPA_2	TTATTGCACAATAT	ATATTGTGCAATAA
CEBPA_3	ATTGCACAAT	ATTGTGCAAT
CEBPB	TATTGCACAAT	ATTGTGCAATA
CEBPB_2	ATTGCGCAAT	ATTGCGCAAT
CEBPB_3	TATTGCGCAATA	TATTGCGCAATA
CEBPB_4	ATTGCGCAAT	ATTGCGCAAT
CEBPD	ATTGCGCAAT	ATTGCGCAAT
CEBPD_2	TATTGCACAATAT	ATATTGTGCAATA
CEBPD_3	TTGCACAA	TTGTGCAA
CEBPE	ATTGCGCAAT	ATTGCGCAAT
CEBPE_2	TATTGCGCAATA	TATTGCGCAATA
CEBPE_3	ATTGCGCAAT	ATTGCGCAAT
CEBPG	ATTGCGCAAT	ATTGCGCAAT
CEBPG_2	AAATGATGCAATCAT	ATGATTGCATCATTT
CEBPG_3	ATGATGCAAT	ATTGCATCAT
CEBPZ	CCCCGCCCCG	CGGGGCGGGG
CLOCK	AACACGTGTT	AACACGTGTT
CLOCK_2	AAACACGTGC	GCACGTGTTT
CLOCK_3	ACACGTG	CACGTGT
CREB1	CCTGGTGACGTC	GACGTCACCAGG
CREB1_2	TGACGTCA	TGACGTCA
CREB1_3	GGTGACGTCACC	GGTGACGTCACC
CREB1_4	TTATGATGTCATA	TATGACATCATAA
CREB1_5	TGATGTCA	TGACATCA
CREB3	GTGCCACGTCATCA	TGATGACGTGGCAC
CREB3_2	TGCCACGTCATC	GATGACGTGGCA
CREB3L1	ATGCCACGTCATCA	TGATGACGTGGCAT
CREB3L1_2	TGCCACGTCATCA	TGATGACGTGGCA
CREB3L4	TGCCACGTCACC	GGTGACGTGGCA
CREB3L4_2	GGTGACGTCACC	GGTGACGTCACC
CREB3L4_3	GCCACGTCAC	GTGACGTGGC
CREB3L4_4	GTGACGTCA	TGACGTCAC
CREM	GCAGTGACGTCACTGC	GCAGTGACGTCACTGC
CREM_2	GTGACGTCAC	GTGACGTCAC
CTCF	TGGCCACCAGGGGGCGCTA	TAGCGCCCCCTGGTGGCCA
CTCF_2	CTGCAGTTCCAGCTGTGGCCACCAGGGGGCGCTA	TAGCGCCCCCTGGTGGCCACAGCTGGAACTGCAG
CTCF_3	CTGCAGTTCCCCCTTCTGGCCACTAGGGGGCGCTA	TAGCGCCCCCTAGTGGCCAGAAGGGGGAACTGCAG
CTCF_4	GCCACCAGGGGGCGC	GCGCCCCCTGGTGGC
CTCF_5	CTGCAGTTCCAGCTGTGGCCACCAGGGGGCG	CGCCCCCTGGTGGCCACAGCTGGAACTGCAG
CTCF_6	CTGCAGTTCCCCCTTCTGGCCACTAGGGGGCGC	GCGCCCCCTAGTGGCCAGAAGGGGGAACTGCAG
CTCFL	CACCAGGGGGCACC	GGTGCCCCCTGGTG
CTCFL_2	AGCAGGGGGCGC	GCGCCCCCTGCT
CTCFL_3	CAGGGGGC	GCCCCCTG
CUX1	TAATCGATAA	TTATCGATTA
CUX1_2	TAATCGATAA	TTATCGATTA
CUX1_3	TAATCGATA	TATCGATTA
CUX1::HOXA13	ATCGATTACCTCATAAA	TTTATGAGGTAATCGAT
CUX1::HOXB13	CTCATAAACATCGATC	GATCGATGTTTATGAG
CUX1::TBX21	TCACACCCAATA	TATTGGGTGTGA
CUX1::TBX21_2	TCACACCCAAT	ATTGGGTGTGA
CUX2	TAATCGATAA	TTATCGATTA
CUX2_2	TAATCGATA	TATCGATTA
DBP	TATTACGTAACA	TGTTACGTAATA
DBP_2	ATTACGTAAC	GTTACGTAAT
DLX1	GCAATTAC	GTAATTGC
DLX1_2	CAATTA	TAATTG
DLX5	GCAATTAC	GTAATTGC
DLX6	CCAATTAC	GTAATTGG
DLX6_2	CAATTA	TAATTG
DMRT3	AATGTATCAAT	ATTGATACATT
DMRT3_2	TGTATCA	TGATACA
DMRTA1	AATTGTTACATT	AATGTAACAATT
DMRTA1_2	TTGTTACATT	AATGTAACAA
DMRTA2	AATTGTTACATT	AATGTAACAATT
DMRTA2_2	GTTACA	TGTAAC
DMRTC2	AATTGATACATT	AATGTATCAATT
DMRTC2_2	AATTGATACAT	ATGTATCAATT
DPRX	AGATAATCCC	GGGATTATCT
DPRX_2	AGATAATCC	GGATTATCT
DRGX	CTAATTAC	GTAATTAG
DRGX_2	TAATTA	TAATTA
DUX4	TAATTTAATCA	TGATTAAATTA
DUXA	CTAATTTAATCAA	TTGATTAAATTAG
DUXA_2	TTGATTTAATCAA	TTGATTAAATCAA
E2F1	TTTGGCGC	GCGCCAAA
E2F1_2	CGGGCGGGAGG	CCTCCCGCCCG
E2F1_3	TTTGGCGCCAAA	TTTGGCGCCAAA
E2F1::HES7	GGCACGTGCCGTTGGCGCCC	GGGCGCCAACGGCACGTGCC
E2F1::HES7_2	GGCACGTGCCGCAAGGCGCCC	GGGCGCCTTGCGGCACGTGCC
E2F1::HES7_3	GGCACGTGCCGTTGGCGCC	GGCGCCAACGGCACGTGCC
E2F1::HES7_4	GGCACGTGCCGCAAGGCGCC	GGCGCCTTGCGGCACGTGCC
E2F2	AAAATGGCGCCATTTT	AAAATGGCGCCATTTT
E2F2_2	GTTTTGGCGCCATTTC	GAAATGGCGCCAAAAC
E2F2_3	TTTTGGCGCCATT	AATGGCGCCAAAA
E2F3	AAAAATGGCGCCATTTTT	AAAAATGGCGCCATTTTT
E2F3_2	ATTTTGGCGCCAAAAT	ATTTTGGCGCCAAAAT
E2F3_3	TTTTGGCGCCAAAA	TTTTGGCGCCAAAA
E2F3::DRGX	GGCGCTAATTGC	GCAATTAGCGCC
E2F3::DRGX_2	GGCGCTAATT	AATTAGCGCC
E2F3::ONECUT2	AGGGCGCCATTATCGATT	AATCGATAATGGCGCCCT
E2F3::ONECUT2_2	ATGGCGCGAATTATCGATC	GATCGATAATTCGCGCCAT
E2F3::ONECUT2_3	GCGCCATTATCGAT	ATCGATAATGGCGC
E2F3::ONECUT2_4	GCGCGAATTATCGAT	ATCGATAATTCGCGC
E2F4	GGGCGGGAAGG	CCTTCCCGCCC
E2F4_2	TTTTGGCGCCATTT	AAATGGCGCCAAAA
E2F4_3	TTTTGGCGCCATT	AATGGCGCCAAAA
E2F6	GGGCGGGAAGG	CCTTCCCGCCC
E2F6_2	GGGGGCGGGAAGG	CCTTCCCGCCCCC
E2F6_3	GGCGGGAA	TTCCCGCC
E2F7	TTTTCCCGCCAAAA	TTTTGGCGGGAAAA
E2F8	TTTCCCGCCAAA	TTTGGCGGGAAA
E2F8_2	TTCCCGCCAAAA	TTTTGGCGGGAA
E2F8_3	TTCCCGCCA	TGGCGGGAA
E4F1	CGGAAGT	ACTTCCG
EBF1	GTCCCCAGGGA	TCCCTGGGGAC
EBF1_2	ATTCCCAAGGGAAT	ATTCCCTTGGGAAT
EBF1_3	AGTCCCCAGGGGACT	AGTCCCCTGGGGACT
EBF1_4	TCCCCAGGGGA	TCCCCTGGGGA
EBF3	TTCCCAAGGGAAT	ATTCCCTTGGGAA
EBF3_2	CCCAAGGGA	TCCCTTGGG
EGR1	CCCCCGCCCCCGCC	GGCGGGGGCGGGGG
EGR1_2	TACGCCCACGCATT	AATGCGTGGGCGTA
EGR1_3	CCACGCCCACGCCC	GGGCGTGGGCGTGG
EGR1_4	ACGCCCACGC	GCGTGGGCGT
EGR2	ACGCCCACGCA	TGCGTGGGCGT
EGR3	CTACGCCCACGCACT	AGTGCGTGGGCGTAG
EGR3_2	ACGCCCACGCA	TGCGTGGGCGT
EGR4	TTACGCCCACGCATTT	AAATGCGTGGGCGTAA
EGR4_2	ACGCCCACGCA	TGCGTGGGCGT
EHF	CCTTCCTG	CAGGAAGG
EHF_2	AACCCGGAAGTA	TACTTCCGGGTT
EHF_3	CTCACTTCCTGTTTC	GAAACAGGAAGTGAG
EHF_4	CACTTCCTG	CAGGAAGTG
ELF1	GAACCAGGAAGTG	CACTTCCTGGTTC
ELF1_2	AACCCGGAAGTG	CACTTCCGGGTT
ELF1_3	AAACAGGAAGTGGG	CCCACTTCCTGTTT
ELF1_4	CAGGAAGTG	CACTTCCTG
ELF2	AACCCGGAAGTA	TACTTCCGGGTT
ELF2_2	AACCCGGAAGTA	TACTTCCGGGTT
ELF2_3	ACCCGGAAGT	ACTTCCGGGT
ELF3	AACCCGGAAGTAA	TTACTTCCGGGTT
ELF3_2	TTCCACTTCCTGGT	ACCAGGAAGTGGAA
ELF3_3	CACTTCCTG	CAGGAAGTG
ELF4	AACCCGGAAGTG	CACTTCCGGGTT
ELF5	ACCCGGAAGTA	TACTTCCGGGT
ELK1	GAGCCGGAAG	CTTCCGGCTC
ELK1_2	ACCGGAAGTG	CACTTCCGGT
ELK1_3	ACCGGAAGT	ACTTCCGGT
ELK1::EOMES	ACCGGAAGTAGGTGTGA	TCACACCTACTTCCGGT
ELK1::ETV7	AACCGGACGGATGTCCGGTT	AACCGGACATCCGTCCGGTT
ELK1::ETV7_2	CCGGACGGATGTCCGG	CCGGACATCCGTCCGG
ELK1::FOXI1	ACCGGAAGTGTAAACAT	ATGTTTACACTTCCGGT
ELK1::FOXI1_2	GCCGGAAGGTAAACAT	ATGTTTACCTTCCGGC
ELK1::FOXI1_3	ACCGGAAGTGTAAACA	TGTTTACACTTCCGGT
ELK1::HOXA1	ACCGGAAGTAATTA	TAATTACTTCCGGT
ELK1::HOXA3	GCCGGAAATTGA	TCAATTTCCGGC
ELK1::HOXA3_2	CCGGAAATTG	CAATTTCCGG
ELK1::HOXB13	ACCGGAAGTTGTAAAA	TTTTACAACTTCCGGT
ELK1::HOXB13_2	ACCGGAAGTTGTAAA	TTTACAACTTCCGGT
ELK1::ONECUT2	ACCGGAACCGATCGATAC	GTATCGATCGGTTCCGGT
ELK1::ONECUT2_2	ACCGGAACCGATCGAT	ATCGATCGGTTCCGGT
ELK1::PAX1	ACCGGAACTACGCTTCACTG	CAGTGAAGCGTAGTTCCGGT
ELK1::PAX5	ACCGGAACTACGCATCACTG	CAGTGATGCGTAGTTCCGGT
ELK1::PAX9	ACCGGAACTACGCTTGACTG	CAGTCAAGCGTAGTTCCGGT
ELK1::SPDEF	ACCGGACGGATATCCGGG	CCCGGATATCCGTCCGGT
ELK1::SPDEF_2	CCGGACGGATATCCGG	CCGGATATCCGTCCGG
ELK1::SREBF2	ACCGGAAGTGGCGTGA	TCACGCCACTTCCGGT
ELK1::SREBF2_2	CCGGAAGTGGCGTGA	TCACGCCACTTCCGG
ELK1::TEF	ACCGGAAGTTACGTAAC	GTTACGTAACTTCCGGT
ELK1::TEF_2	CCGGAAGTTACGTAA	TTACGTAACTTCCGG
ELK3	ACCGGAAGTA	TACTTCCGGT
ELK3_2	ACCGGAAGTGG	CCACTTCCGGT
ELK3_3	ACCGGAAGT	ACTTCCGGT
ELK4	ACCGGAAGT	ACTTCCGGT
ELK4_2	CCACTTCCGGC	GCCGGAAGTGG
ELK4_3	CACTTCCGG	CCGGAAGTG
EMX1	CCTAATTACC	GGTAATTAGG
EMX1_2	CTAATTAG	CTAATTAG
EMX1_3	TAATTA	TAATTA
EMX2	GCTAATTAGC	GCTAATTAGC
EMX2_2	TAATTA	TAATTA
EN1	CTAATTAG	CTAATTAG
EN1_2	TAATTA	TAATTA
EN2	CCCAATTAGC	GCTAATTGGG
EN2_2	CCCAATTA	TAATTGGG
EN2_3	CCAATTA	TAATTGG
EOMES	AAGGTGTGAAAAT	ATTTTCACACCTT
EOMES_2	AGGTGTGAA	TTCACACCT
EPAS1	CGCACGTAC	GTACGTGCG
ERF	ACCGGAAGTG	CACTTCCGGT
ERF_2	ACCGGAAGT	ACTTCCGGT
ERF::CEBPD	AGCGGAAATTGCGCAAT	ATTGCGCAATTTCCGCT
ERF::CEBPD_2	CGGAAATTGCGCAAT	ATTGCGCAATTTCCG
ERF::ETV7	ACCGGACGGATGTCCGGG	CCCGGACATCCGTCCGGT
ERF::ETV7_2	GGACGGATGTCC	GGACATCCGTCC
ERF::FIGLA	ACCGGAAACACCTGGT	ACCAGGTGTTTCCGGT
ERF::FIGLA_2	CCGGAAACACCTG	CAGGTGTTTCCGG
ERF::FOXI1	GTAAACAGGAAGTG	CACTTCCTGTTTAC
ERF::FOXI1_2	AAACAGGAAG	CTTCCTGTTT
ERF::FOXO1	GTAAACAGGAAGTG	CACTTCCTGTTTAC
ERF::FOXO1_2	GTAAACAGGAAG	CTTCCTGTTTAC
ERF::HOXB13	ACCGGAAGTCGTAAAA	TTTTACGACTTCCGGT
ERF::HOXB13_2	CGGAAGTCGTAAA	TTTACGACTTCCG
ERF::MAX	ACCGGAAACACGTGG	CCACGTGTTTCCGGT
ERF::MAX_2	CCGGAAACACGTG	CACGTGTTTCCGG
ERF::NHLH1	AGCAGCTGCCGGAAGTA	TACTTCCGGCAGCTGCT
ERF::NHLH1_2	AGCAGCTGCCGGAAGT	ACTTCCGGCAGCTGCT
ERF::SREBF2	GCCGGAAATCACGTGAT	ATCACGTGATTTCCGGC
ERF::SREBF2_2	CCGGAAATCACGTGAT	ATCACGTGATTTCCGG
ERF::TBX21	TCACACCGGAAG	CTTCCGGTGTGA
ERG	ACCGGAAGTG	CACTTCCGGT
ESR1	CCAGGTCACCGTGACCCC	GGGGTCACGGTGACCTGG
ESR1_2	GGCCCAGGTCACCCTGACCT	AGGTCAGGGTGACCTGGGCC
ESR1_3	AAGGTCACGGTGACCTG	CAGGTCACCGTGACCTT
ESR1_4	AGGTCACGGTGACCT	AGGTCACCGTGACCT
ESR2	CAAGGTCACGGTGACCTG	CAGGTCACCGTGACCTTG
ESR2_2	AGGTCACCCTGACCT	AGGTCAGGGTGACCT
ESR2_3	GCCAGGTCAGGG	CCCTGACCTGGC
ESR2_4	AGGTCAG	CTGACCT
ESRRA	CCAAGGTCACA	TGTGACCTTGG
ESRRA_2	GCTCAAGGTCACA	TGTGACCTTGAGC
ESRRA_3	TCAAGGTCA	TGACCTTGA
ESRRB	TCAAGGTCATA	TATGACCTTGA
ESRRB_2	TCAAGGTCAT	ATGACCTTGA
ESX1	ACCAATTAAC	GTTAATTGGT
ESX1_2	CTAATTAG	CTAATTAG
ESX1_3	CTAATTA	TAATTAG
ETS1	CTTCCG	CGGAAG
ETS1_2	ACCGGAAGTG	CACTTCCGGT
ETS1_3	ACCGGAAGT	ACTTCCGGT
ETS2	GACCGGAAGT	ACTTCCGGTC
ETS2_2	ACCGGAAGT	ACTTCCGGT
ETV1	ACCGGAAGTA	TACTTCCGGT
ETV1_2	AAACAGGAAGTGAA	TTCACTTCCTGTTT
ETV1_3	ACAGGAAGT	ACTTCCTGT
ETV2	AACCGGAAATA	TATTTCCGGTT
ETV2_2	ACCGGAAAT	ATTTCCGGT
ETV2::BHLHA15	ACCGGAAACATATGG	CCATATGTTTCCGGT
ETV2::CEBPD	ACCGGAAGTTGCGCAAC	GTTGCGCAACTTCCGGT
ETV2::CEBPD_2	CCGGAAGTTGCGCAA	TTGCGCAACTTCCGG
ETV2::DRGX	ACCGGAAGTAATTA	TAATTACTTCCGGT
ETV2::DRGX_2	CGGAAGTAATTA	TAATTACTTCCG
ETV2::EOMES	TCACACCGGAAGT	ACTTCCGGTGTGA
ETV2::EOMES_2	TCACACCGGAAG	CTTCCGGTGTGA
ETV2::ETV7	ACCGGACGGATTTCCGCG	CGCGGAAATCCGTCCGGT
ETV2::ETV7_2	GGACGGATTTCC	GGAAATCCGTCC
ETV2::FIGLA	ACCGGAAACAGGTGGT	ACCACCTGTTTCCGGT
ETV2::FIGLA_2	CCGGAAACAGGTG	CACCTGTTTCCGG
ETV2::FOXI1	CGTAAACAGGAAGTG	CACTTCCTGTTTACG
ETV2::FOXI1_2	ACCGGAAGTGTAAACAT	ATGTTTACACTTCCGGT
ETV2::FOXI1_3	ACCGGATGTTGA	TCAACATCCGGT
ETV2::FOXI1_4	TGTTGACGGAAGTG	CACTTCCGTCAACA
ETV2::FOXI1_5	AAACAGGAAGT	ACTTCCTGTTT
ETV2::FOXI1_6	CCGGAAGTGTAAACA	TGTTTACACTTCCGG
ETV2::FOXI1_7	ACCGGATGTTG	CAACATCCGGT
ETV2::FOXI1_8	TGTTGACGGAAGT	ACTTCCGTCAACA
ETV2::FOXO6	ACCGGATGTTTTC	GAAAACATCCGGT
ETV2::FOXO6_2	ACCGGATGTTT	AAACATCCGGT
ETV2::HOXB13	ACCGGAAACATAAAC	GTTTATGTTTCCGGT
ETV2::HOXB13_2	CCGGAAACATAAA	TTTATGTTTCCGG
ETV2::NHLH1	AGCAGCTGCCGGAAGTT	AACTTCCGGCAGCTGCT
ETV2::NHLH1_2	AGCAGCTGCCGGAAGT	ACTTCCGGCAGCTGCT
ETV2::ONECUT2	AATCAATACCGGAAGTG	CACTTCCGGTATTGATT
ETV2::ONECUT2_2	AATCGATAACCGGAAGTG	CACTTCCGGTTATCGATT
ETV2::ONECUT2_3	ATCAATACCGGAAGT	ACTTCCGGTATTGAT
ETV2::ONECUT2_4	AATCGATAACCGGAAGT	ACTTCCGGTTATCGATT
ETV2::SPDEF	GCCGGACGGAAATCCGCCT	AGGCGGATTTCCGTCCGGC
ETV2::SPDEF_2	CGGACGGAAATCCGC	GCGGATTTCCGTCCG
ETV2::SREBF2	ATGACGTGACGGAAGT	ACTTCCGTCACGTCAT
ETV2::SREBF2_2	ATGACGTGACGGAAG	CTTCCGTCACGTCAT
ETV2::TEF	ACCGGAAGTTACGTAAC	GTTACGTAACTTCCGGT
ETV2::TEF_2	CCGGAAGTTACGTAAC	GTTACGTAACTTCCGG
ETV3	ACCGGAAGTG	CACTTCCGGT
ETV3_2	ACCGGAAGT	ACTTCCGGT
ETV4	ACCGGAAGTA	TACTTCCGGT
ETV4_2	ACAGGAAGTG	CACTTCCTGT
ETV4_3	ACCGGAAGTG	CACTTCCGGT
ETV4_4	ACCGGAAGT	ACTTCCGGT
ETV5	ACCGGAAGTG	CACTTCCGGT
ETV5_2	CCACTTCCGGC	GCCGGAAGTGG
ETV5_3	ACCGGAAGTG	CACTTCCGGT
ETV5_4	ACCGGAAGT	ACTTCCGGT
ETV5::CEBPD	GCCGGATGTTGCGCAAT	ATTGCGCAACATCCGGC
ETV5::CEBPD_2	CCGGATGTTGCGCAAT	ATTGCGCAACATCCGG
ETV5::DRGX	ACCGGAAGTAATTA	TAATTACTTCCGGT
ETV5::DRGX_2	CGGAAGTAATTA	TAATTACTTCCG
ETV5::ETV7	GGGGAAGGATGTCCGGG	CCCGGACATCCTTCCCC
ETV5::ETV7_2	GGAAGGATGTCC	GGACATCCTTCC
ETV5::FIGLA	GGCGGAAGCAGGTGG	CCACCTGCTTCCGCC
ETV5::FIGLA_2	GGCGGAAGCAGGTG	CACCTGCTTCCGCC
ETV5::FOXI1	GTAAACAGGAAGT	ACTTCCTGTTTAC
ETV5::FOXI1_2	GTAAACAGGAAG	CTTCCTGTTTAC
ETV5::FOXO1	GTAAACAGGAAGT	ACTTCCTGTTTAC
ETV5::FOXO1_2	GTAAACAGGA	TCCTGTTTAC
ETV5::HOXA2	AGCGGAAGTAATTA	TAATTACTTCCGCT
ETV5::HOXA2_2	CGGAAGTAATTA	TAATTACTTCCG
ETV6	AGCGGAAGTG	CACTTCCGCT
ETV6_2	GCGGAAGTG	CACTTCCGC
ETV7	AGGCGGAAGTG	CACTTCCGCCT
ETV7_2	GCGGAAGTG	CACTTCCGC
EVX1	GGTAATTAGC	GCTAATTACC
EVX1_2	TAATTA	TAATTA
EVX2	GGTAATTAGC	GCTAATTACC
EVX2_2	TAATTA	TAATTA
EWSR1-FLI1	GGAAGGAAGGAAGGAAGG	CCTTCCTTCCTTCCTTCC
FERD3L	GCAACAGCTGTTAC	GTAACAGCTGTTGC
FEV	CAGGAAAT	ATTTCCTG
FEV_2	ACCGGAAGTG	CACTTCCGGT
FEV_3	AACCGGAAGTGA	TCACTTCCGGTT
FEV_4	ACCGGAAGT	ACTTCCGGT
FEZF1	ATAAAAGGCAG	CTGCCTTTTAT
FEZF1_2	AAAAGGC	GCCTTTT
FEZF2	CCCAGCCT	AGGCTGGG
FIGLA	ACCACCTGTT	AACAGGTGGT
FIGLA_2	CACCTG	CAGGTG
FLI1	ACAGGAAGTGG	CCACTTCCTGT
FLI1_2	ACCGGAAGTG	CACTTCCGGT
FLI1_3	ACCGGAAGT	ACTTCCGGT
FLI1::BHLHA15	ACCGGAAACATATGG	CCATATGTTTCCGGT
FLI1::BHLHA15_2	CCGGAAACATATGG	CCATATGTTTCCGG
FLI1::CEBPB	ACCGGAAGTTGCGCAAT	ATTGCGCAACTTCCGGT
FLI1::CEBPD	ACCGGAAATTGCGCAAT	ATTGCGCAATTTCCGGT
FLI1::CEBPD_2	CGGAAATTGCGCAAT	ATTGCGCAATTTCCG
FLI1::DRGX	ACCGGAAGTAATTAT	ATAATTACTTCCGGT
FLI1::DRGX_2	ACCGGAAGTAATTA	TAATTACTTCCGGT
FLI1::ETV7	ACCGGACGGATTTCCGGT	ACCGGAAATCCGTCCGGT
FLI1::ETV7_2	CGGACGGATTTCCG	CGGAAATCCGTCCG
FLI1::FIGLA	ACCGGAAACAGCTGG	CCAGCTGTTTCCGGT
FLI1::FIGLA_2	CCGGAAACAGCTG	CAGCTGTTTCCGG
FLI1::FOXI1	GTAAACAGGAAGTG	CACTTCCTGTTTAC
FLI1::FOXI1_2	ACCGGATGTTTAC	GTAAACATCCGGT
FLI1::FOXI1_3	TAAACAGGAAG	CTTCCTGTTTA
FLI1::FOXI1_4	CCGGATGTTTA	TAAACATCCGG
FLI1::HOXB13	ACCGGAAGTCGTAAAA	TTTTACGACTTCCGGT
FLI1::MAX	ACCGGAAACACGTGG	CCACGTGTTTCCGGT
FLI1::MAX_2	CCGGAAACACGTG	CACGTGTTTCCGG
FOS	TGTGACTCATT	AATGAGTCACA
FOS_2	TGATGACGTCATCA	TGATGACGTCATCA
FOS_3	TGACTCAT	ATGAGTCA
FOS_4	GATGACGTCATCA	TGATGACGTCATC
FOS::JUN	TGACTCA	TGAGTCA
FOS::JUN_2	ATGAGTCATC	GATGACTCAT
FOS::JUN_3	GATGACGTCATCATTT	AAATGATGACGTCATC
FOS::JUN_4	ATGAGTCAT	ATGACTCAT
FOS::JUN_5	ATGACGTCAT	ATGACGTCAT
FOS::JUNB	GATGAGTCATCC	GGATGACTCATC
FOS::JUNB_2	ATGAGTCAT	ATGACTCAT
FOS::JUND	GGATGAGTCATCG	CGATGACTCATCC
FOS::JUND_2	ATGAGTCAT	ATGACTCAT
FOSB	GATGACGTCATC	GATGACGTCATC
FOSB_2	ATGACGTCAT	ATGACGTCAT
FOSB::JUN	GATGACGTCAT	ATGACGTCATC
FOSB::JUNB	GATGACTCAT	ATGAGTCATC
FOSB::JUNB_2	ATGACGTCAT	ATGACGTCAT
FOSB::JUNB_3	ATGACTCAT	ATGAGTCAT
FOSL1	GGTGACTCATG	CATGAGTCACC
FOSL1_2	TGATGACTCATCC	GGATGAGTCATCA
FOSL1_3	ATGACTCAT	ATGAGTCAT
FOSL1::JUN	TGATGACTCATCC	GGATGAGTCATCA
FOSL1::JUN_2	ATGACGTCAT	ATGACGTCAT
FOSL1::JUN_3	ATGACTCAT	ATGAGTCAT
FOSL1::JUNB	TGATGACTCATAC	GTATGAGTCATCA
FOSL1::JUNB_2	ATGACTCAT	ATGAGTCAT
FOSL1::JUND	GATGACTCAT	ATGAGTCATC
FOSL1::JUND_2	ATGACGTAAC	GTTACGTCAT
FOSL1::JUND_3	ATGACTCA	TGAGTCAT
FOSL1::JUND_4	ATGACGTAA	TTACGTCAT
FOSL2	GGATGACTCAT	ATGAGTCATCC
FOSL2_2	GATGACTCAT	ATGAGTCATC
FOSL2::JUN	GGATGAGTCATC	GATGACTCATCC
FOSL2::JUN_2	GATGACGTCAT	ATGACGTCATC
FOSL2::JUN_3	ATGAGTCAT	ATGACTCAT
FOSL2::JUN_4	ATGACGTCAT	ATGACGTCAT
FOSL2::JUNB	GATGACTCAT	ATGAGTCATC
FOSL2::JUNB_2	GATGACGTCATC	GATGACGTCATC
FOSL2::JUNB_3	ATGACTCAT	ATGAGTCAT
FOSL2::JUNB_4	ATGACGTCAT	ATGACGTCAT
FOSL2::JUND	GATGACTCAT	ATGAGTCATC
FOSL2::JUND_2	TGATGACGTCATCGC	GCGATGACGTCATCA
FOSL2::JUND_3	ATGACTCAT	ATGAGTCAT
FOSL2::JUND_4	ATGACGTCAT	ATGACGTCAT
FOXA1	TGTTTACTTTG	CAAAGTAAACA
FOXA1_2	TGTTTACTTTG	CAAAGTAAACA
FOXA1_3	TCCATGTTTACTTTG	CAAAGTAAACATGGA
FOXA1_4	ATGTAAACATGT	ACATGTTTACAT
FOXA1_5	GTAAACAT	ATGTTTAC
FOXA2	ATGTAAACATA	TATGTTTACAT
FOXA2_2	TGTAAACA	TGTTTACA
FOXA3	ATGTAAACATA	TATGTTTACAT
FOXA3_2	GTAAACA	TGTTTAC
FOXB1	TATGTAAATAT	ATATTTACATA
FOXC1	GGTAAGTA	TACTTACC
FOXC1_2	TATGTAAATAT	ATATTTACATA
FOXC2	TAAGTAAACAAA	TTTGTTTACTTA
FOXC2_2	TAAGTAAACAA	TTGTTTACTTA
FOXD1	GTAAACAT	ATGTTTAC
FOXD1_2	GTAAACA	TGTTTAC
FOXD2	GTAAACA	TGTTTAC
FOXD2_2	GTTAAGTAAACAA	TTGTTTACTTAAC
FOXD2_3	CTTAAACAAACA	TGTTTGTTTAAG
FOXD2_4	TTAAACAAACA	TGTTTGTTTAA
FOXD3	AAAGTAAATAAACAAT	ATTGTTTATTTACTTT
FOXD3_2	AAAGTAAATAAACA	TGTTTATTTACTTT
FOXE1	CCTTAAATAAACAAT	ATTGTTTATTTAAGG
FOXE1_2	CCTAAATAAACAAA	TTTGTTTATTTAGG
FOXE1_3	CTAAATAAACAA	TTGTTTATTTAG
FOXF2	CAAACGTAAACAAT	ATTGTTTACGTTTG
FOXF2_2	CGTAAACAA	TTGTTTACG
FOXG1	GTAAACAA	TTGTTTAC
FOXH1	TCCAATCCACA	TGTGGATTGGA
FOXH1_2	AATCCACA	TGTGGATT
FOXI1	GGATGTTTGTTT	AAACAAACATCC
FOXI1_2	GTAAACA	TGTTTAC
FOXJ2::ELF1	ATAAACAGGAAGTA	TACTTCCTGTTTAT
FOXJ2::ELF1_2	AAACAGGAAGT	ACTTCCTGTTT
FOXJ2::HOXB13	GTAAACAAATAAAA	TTTTATTTGTTTAC
FOXJ2::PITX1	TAAACAGGATTA	TAATCCTGTTTA
FOXK1	AATGTAAACAAGGC	GCCTTGTTTACATT
FOXK1_2	GTAAACA	TGTTTAC
FOXK2	ATGTAAACAAG	CTTGTTTACAT
FOXK2_2	ATGTAAACAAG	CTTGTTTACAT
FOXK2_3	GTAAACA	TGTTTAC
FOXL1	TATACATA	TATGTATA
FOXL1_2	GTAAACA	TGTTTAC
FOXM1	GTAAACA	TGTTTAC
FOXN3	GTAAACAA	TTGTTTAC
FOXO1::ELF1	GTAAACAGGAAGTA	TACTTCCTGTTTAC
FOXO1::ELF1_2	GTGTTGCCGGAAGTG	CACTTCCGGCAACAC
FOXO1::ELF1_3	GTAAACAGGAAGT	ACTTCCTGTTTAC
FOXO1::ELF1_4	TGTTGCCGGAAG	CTTCCGGCAACA
FOXO1::ELK1	ATCAACAGGAAGTG	CACTTCCTGTTGAT
FOXO1::ELK1_2	GCCGGATGTTGTG	CACAACATCCGGC
FOXO1::ELK1_3	ATCAACAGGAAGT	ACTTCCTGTTGAT
FOXO1::ELK1_4	GCCGGATGTTGT	ACAACATCCGGC
FOXO1::ELK3	GTAAACAGGAAGTG	CACTTCCTGTTTAC
FOXO1::ELK3_2	GTAAACAGGAAGT	ACTTCCTGTTTAC
FOXO1::FLI1	GTAAACAGGAAGTG	CACTTCCTGTTTAC
FOXO1::FLI1_2	GTAAACAGGAAGT	ACTTCCTGTTTAC
FOXO3	TGTAAACA	TGTTTACA
FOXO3_2	GTAAACAA	TTGTTTAC
FOXO4	GTAAACA	TGTTTAC
FOXO6	GTAAACA	TGTTTAC
FOXP1	CAAAAGTAAACAAAG	CTTTGTTTACTTTTG
FOXP1_2	AAGTAAACAGAA	TTCTGTTTACTT
FOXP1_3	ATGTAAACATA	TATGTTTACAT
FOXP1_4	GTAAACA	TGTTTAC
FOXP2	AAGTAAACAAA	TTTGTTTACTT
FOXP2_2	AGTAAACAA	TTGTTTACT
FOXP3	GTAAACA	TGTTTAC
FOXP4	GTAAACA	TGTTTAC
FOXR2	ATATAAACATAAATAAA	TTTATTTATGTTTATAT
FOXR2_2	ATATAAACATAAATAA	TTATTTATGTTTATAT
FOXS1	TGTAAACA	TGTTTACA
GABPA	ACCGGAAGAG	CTCTTCCGGT
GABPA_2	CCCACTTCCTGTTT	AAACAGGAAGTGGG
GABPA_3	CACTTCCTGT	ACAGGAAGTG
GATA1	TTCTAATCTAT	ATAGATTAGAA
GATA1_2	CTAATCT	AGATTAG
GATA1::TAL1	CTTATCTGTGAGGAGCAG	CTGCTCCTCACAGATAAG
GATA1::TAL1_2	TTATCTGTGAGGAGCAG	CTGCTCCTCACAGATAA
GATA2	GGATA	TATCC
GATA2_2	AGATTCTTATCTGT	ACAGATAAGAATCT
GATA2_3	TTCTTATCTTT	AAAGATAAGAA
GATA2_4	CTTATCT	AGATAAG
GATA3	AGATAG	CTATCT
GATA3_2	AGATAAGA	TCTTATCT
GATA3_3	AGATAAGA	TCTTATCT
GATA4	TTCCTTATCTTT	AAAGATAAGGAA
GATA4_2	CCTTATCT	AGATAAGG
GATA5	AGATAAGA	TCTTATCT
GATA5_2	CAGATAAGGA	TCCTTATCTG
GATA5_3	AGATAAGG	CCTTATCT
GATA6	AAAAGATAAGAAA	TTTCTTATCTTTT
GATA6_2	TTATCTTATCTTT	AAAGATAAGATAA
GATA6_3	TCTTATCT	AGATAAGA
GBX1	ACTAATTAGC	GCTAATTAGT
GBX1_2	CTAATTA	TAATTAG
GBX2	ACCAATTAGC	GCTAATTGGT
GBX2_2	CAATTA	TAATTG
GCM1	CATGCGGGTAC	GTACCCGCATG
GCM1_2	ATGCGGGTAC	GTACCCGCAT
GCM1::ELF1	CACCCGCACGGAAGTG	CACTTCCGTGCGGGTG
GCM1::ELF1_2	ACCCGCACGGAAGT	ACTTCCGTGCGGGT
GCM1::ELK1	ATGCGGGCGGAAGTG	CACTTCCGCCCGCAT
GCM1::ELK1_2	TGCGGGCGGAAG	CTTCCGCCCGCA
GCM1::ELK3	ACCCGCAGCCGGAAGT	ACTTCCGGCTGCGGGT
GCM1::ELK3_2	ATGCGGGCGGAAGTG	CACTTCCGCCCGCAT
GCM1::ETV4	ATGCGGGCGGAAGTG	CACTTCCGCCCGCAT
GCM1::ETV4_2	ATGCGGGCGGAAGT	ACTTCCGCCCGCAT
GCM1::FOXI1	GTGTTGATGCGGGC	GCCCGCATCAACAC
GCM1::FOXI1_2	TGTTGATGCGGG	CCCGCATCAACA
GCM1::HOXB13	ACCCGCACCAATAAA	TTTATTGGTGCGGGT
GCM1::HOXB13_2	ATGCGGGTAATAAAA	TTTTATTACCCGCAT
GCM1::HOXB13_3	CCCGCACCAATAAA	TTTATTGGTGCGGG
GCM1::HOXB13_4	ATGCGGGTAATAAA	TTTATTACCCGCAT
GCM1::ONECUT2	ATGCGGGAAATCGATA	TATCGATTTCCCGCAT
GCM1::ONECUT2_2	ATGCGGGAAATCGAT	ATCGATTTCCCGCAT
GCM1::SOX2	ATGCGGGTGCATTGTTC	GAACAATGCACCCGCAT
GCM1::SOX2_2	ATGCGGGTGCATTGTT	AACAATGCACCCGCAT
GCM1::TBX21	AGGTGTCATGCGGGTT	AACCCGCATGACACCT
GCM1::TBX21_2	AGGTGTCATGCGGG	CCCGCATGACACCT
GCM2	TATGCGGGTA	TACCCGCATA
GCM2_2	ATGCGGGT	ACCCGCAT
GCM2::DRGX	ATGCGGGTAATTAG	CTAATTACCCGCAT
GCM2::DRGX_2	ATGCGGGTAATTA	TAATTACCCGCAT
GCM2::ELK1	ATGCGGGCGGAAGTG	CACTTCCGCCCGCAT
GCM2::ELK1_2	TGCGGGCGGAAGT	ACTTCCGCCCGCA
GCM2::HOXA13	ATGCGGGTAATAAAA	TTTTATTACCCGCAT
GCM2::HOXA13_2	ATGCGGGTAATAAA	TTTATTACCCGCAT
GCM2::PITX1	ATGCGGGCGATTAG	CTAATCGCCCGCAT
GCM2::PITX1_2	TGCGGGCGATTA	TAATCGCCCGCA
GCM2::TBX21	AGGTGTCATGGGGGT	ACCCCCATGACACCT
GCM2::TBX21_2	AGGTGTCATGGGGG	CCCCCATGACACCT
GFI1	CAAATCACTGCA	TGCAGTGATTTG
GFI1_2	AAATCACTGCA	TGCAGTGATTT
GLI2	GCGACCACACTG	CAGTGTGGTCGC
GLI2_2	AGACCACCCACGTCG	CGACGTGGGTGGTCT
GLI3	AGACCACCCACGTCG	CGACGTGGGTGGTCT
GLI3_2	GGACCACCCACGTCGC	GCGACGTGGGTGGTCC
GLI3_3	GGACCACCCACGTCG	CGACGTGGGTGGTCC
GLI4	GGGGGCCTTGAA	TTCAAGGCCCCC
GLI4_2	GGGCCTTGAA	TTCAAGGCCC
GLIS1	AGACCCCCCACGAAGC	GCTTCGTGGGGGGTCT
GLIS1_2	AGACCCCCCACGAAG	CTTCGTGGGGGGTCT
GLIS2	GACCCCCCGCGAAG	CTTCGCGGGGGGTC
GLIS3	GACCCCCCACGAAG	CTTCGTGGGGGGTC
GMEB2	TTACGTAA	TTACGTAA
GRHL1	AAAACCGGTTTT	AAAACCGGTTTT
GRHL1_2	AAACCGGTTT	AAACCGGTTT
GRHL2	GACAAACCAGTTTTT	AAAAACTGGTTTGTC
GRHL2_2	AAAACAGGTTTT	AAAACCTGTTTT
GRHL2_3	AACAGGTT	AACCTGTT
GSC	GCTAATCCCC	GGGGATTAGC
GSC_2	TAATCC	GGATTA
GSC2	CCTAATCCGC	GCGGATTAGG
GSC2_2	TAATCC	GGATTA
GSX1	CCTAATTAAA	TTTAATTAGG
GSX1_2	TAATTA	TAATTA
GSX2	ACTAATTAAA	TTTAATTAGT
GSX2_2	GTAATTAG	CTAATTAC
GSX2_3	GTAATTA	TAATTAC
HAND2	ACCAGATGGC	GCCATCTGGT
HAND2_2	CAGATG	CATCTG
HES1	GGCACGTGGC	GCCACGTGCC
HES1_2	GGCACGTG	CACGTGCC
HES2	GGCACGTGCC	GGCACGTGCC
HES2_2	GGCACGTGC	GCACGTGCC
HES5	CGGCACGTGCCA	TGGCACGTGCCG
HES5_2	GGCACGTGCC	GGCACGTGCC
HES6	GGCACGTGTT	AACACGTGCC
HES7	TGGCACGTGCCA	TGGCACGTGCCA
HESX1	GCTAATTGGC	GCCAATTAGC
HESX1_2	TAATTG	CAATTA
HEY1	GACACGTGCC	GGCACGTGTC
HEY2	GACACGTGCC	GGCACGTGTC
HEY2_2	GACACGTGC	GCACGTGTC
HIC2	ATGCCCACC	GGTGGGCAT
HIC2_2	ATGCCC	GGGCAT
HIF1A	GTACGTGCCC	GGGCACGTAC
HIF1A_2	ACGTGC	GCACGT
HINFP	TAACGTCCGC	GCGGACGTTA
HINFP_2	CAACGTCCGCGG	CCGCGGACGTTG
HINFP_3	ACGTCCGC	GCGGACGT
HKR1	TAAGGAGGACACA	TGTGTCCTCCTTA
HKR1_2	AAGGAGGACA	TGTCCTCCTT
HLF	GGTTACGCAATA	TATTGCGTAACC
HLF_2	CATTACGTAACC	GGTTACGTAATG
HLF_3	TTGTTATGCAACAA	TTGTTGCATAACAA
HLF_4	TTATGCAAC	GTTGCATAA
HMBOX1	ACTAGTTAAC	GTTAACTAGT
HMBOX1_2	TAGTTAA	TTAACTA
HNF1A	AGTTAATGATTAACT	AGTTAATCATTAACT
HNF1A_2	GTTAATGATTAAC	GTTAATCATTAAC
HNF1B	TTAATATTTAAC	GTTAAATATTAA
HNF1B_2	GTTAATGATTAAC	GTTAATCATTAAC
HNF4A	CTGGACTTTGGACTC	GAGTCCAAAGTCCAG
HNF4A_2	GGGTCCAAAGGTCAC	GTGACCTTTGGACCC
HNF4A_3	TCCAAAGTCCAAA	TTTGGACTTTGGA
HNF4A_4	GGGTCCAAAGGTCA	TGACCTTTGGACCC
HNF4A_5	CAAAGTCCA	TGGACTTTG
HNF4G	AGAGTCCAAAGTCCA	TGGACTTTGGACTCT
HNF4G_2	TCCAAAGTCCAGA	TCTGGACTTTGGA
HNF4G_3	CAAAGTCCA	TGGACTTTG
HOXA1	GTAATTAC	GTAATTAC
HOXA1_2	TAATTA	TAATTA
HOXA10	GGTAATAAAAA	TTTTTATTACC
HOXA10_2	GTAATAAAA	TTTTATTAC
HOXA13	CCAATAAAAA	TTTTTATTGG
HOXA13_2	CCCAATAAAAC	GTTTTATTGGG
HOXA2	CCTAATTACC	GGTAATTAGG
HOXA2_2	GTAATTAG	CTAATTAC
HOXA2_3	TAATTA	TAATTA
HOXA3	GTAATTA	TAATTAC
HOXA4	GTCATTAG	CTAATGAC
HOXA4_2	GTCATTA	TAATGAC
HOXA5	CACTAATT	AATTAGTG
HOXA5_2	GTAATTAC	GTAATTAC
HOXA6	GGTAATTAAC	GTTAATTACC
HOXA6_2	GTAATTA	TAATTAC
HOXA7	GCAATTAC	GTAATTGC
HOXA7_2	GCAATTAA	TTAATTGC
HOXA7_3	CAATTA	TAATTG
HOXA9	GTCGTAAACG	CGTTTACGAC
HOXA9_2	GTCGTAA	TTACGAC
HOXB1	GTAATTA	TAATTAC
HOXB13	CCAATAAAAC	GTTTTATTGG
HOXB13_2	AACCAATAAAATTT	AAATTTTATTGGTT
HOXB13_3	CCAATAAAA	TTTTATTGG
HOXB13::ELK1	ACCGGAAGTCATAAAA	TTTTATGACTTCCGGT
HOXB13::ELK1_2	ACCGGAAGTCATAAA	TTTATGACTTCCGGT
HOXB2	AGTAATTAAC	GTTAATTACT
HOXB2_2	GTAATTAG	CTAATTAC
HOXB2_3	TAATTA	TAATTA
HOXB2::ELK1	ACCGGAAGTCATTA	TAATGACTTCCGGT
HOXB2::ELK1_2	TAATTACCGGAAGTG	CACTTCCGGTAATTA
HOXB2::ELK1_3	TAATTACCGGAAGT	ACTTCCGGTAATTA
HOXB2::PAX1	CCGTCACGCTTCATTAA	TTAATGAAGCGTGACGG
HOXB2::PAX1_2	CGTCACGCTTCATTAA	TTAATGAAGCGTGACG
HOXB2::PAX5	CCGTCACGCATCATTAC	GTAATGATGCGTGACGG
HOXB2::PAX5_2	GTCACGCATCATTAC	GTAATGATGCGTGAC
HOXB2::PAX9	CGTCACGCCTCATTAA	TTAATGAGGCGTGACG
HOXB2::TBX21	GAGGTGTTAATGG	CCATTAACACCTC
HOXB2::TBX21_2	AGGTGTTAATG	CATTAACACCT
HOXB2::TBX3	AGGTGTTAATGG	CCATTAACACCT
HOXB2::TBX3_2	AGGTGTTAATG	CATTAACACCT
HOXB3	ACTAATTAGC	GCTAATTAGT
HOXB3_2	TAATTA	TAATTA
HOXB4	ATCATTAG	CTAATGAT
HOXB4_2	TCATTA	TAATGA
HOXB5	GTAATTAC	GTAATTAC
HOXB5_2	TAATTA	TAATTA
HOXB6	TTAATTAC	GTAATTAA
HOXB6_2	TAATTAC	GTAATTA
HOXB7	GGTAATTAAC	GTTAATTACC
HOXB7_2	GTAATTA	TAATTAC
HOXB8	GCAATTAC	GTAATTGC
HOXB8_2	GCAATTA	TAATTGC
HOXB9	GTCGTAAAAT	ATTTTACGAC
HOXB9_2	GTCGTAAAA	TTTTACGAC
HOXC10	GTCGTAAAAT	ATTTTACGAC
HOXC10_2	GTCGTAAAA	TTTTACGAC
HOXC10::TBX21	TAACACCTCATAAA	TTTATGAGGTGTTA
HOXC11	GGTCGTAAAAT	ATTTTACGACC
HOXC11_2	AGGTCGTAAAAA	TTTTTACGACCT
HOXC11_3	AGGTCGTAAAA	TTTTACGACCT
HOXC12	GGTCGTAAAAA	TTTTTACGACC
HOXC12_2	GGTCGTAAAA	TTTTACGACC
HOXC13	GCTCGTAAAAA	TTTTTACGAGC
HOXC13_2	CTCGTAAAA	TTTTACGAG
HOXC4	GTCATTAA	TTAATGAC
HOXC4_2	TCATTA	TAATGA
HOXC8	GTAATTAC	GTAATTAC
HOXC8_2	TAATTA	TAATTA
HOXC9	GTCGTAAAAT	ATTTTACGAC
HOXC9_2	GTCGTAAAA	TTTTACGAC
HOXD10	GGTCGTAAAAC	GTTTTACGACC
HOXD10_2	GGTCGTAAAA	TTTTACGACC
HOXD11	GTCGTAAAAA	TTTTTACGAC
HOXD11_2	GTCGTAAAA	TTTTACGAC
HOXD12	AGTCGTAAAAA	TTTTTACGACT
HOXD12_2	AGTCGTAAAA	TTTTACGACT
HOXD12::ELK1	GGGCGGAAGTCGTAAAA	TTTTACGACTTCCGCCC
HOXD12::ELK1_2	CGGAAGTCGTAAA	TTTACGACTTCCG
HOXD12::ELK3	TTTTATGACCGGAAGTT	AACTTCCGGTCATAAAA
HOXD12::ELK3_2	TTTATGACCGGAAGT	ACTTCCGGTCATAAA
HOXD12::ETV1	ACCGGAAGTCGTAAAA	TTTTACGACTTCCGGT
HOXD12::ETV1_2	ACCGGAAGTCGTAAA	TTTACGACTTCCGGT
HOXD12::ETV4	ACCGGAAGTCGTAAAA	TTTTACGACTTCCGGT
HOXD12::ETV4_2	CCGGAAGTCGTAAAA	TTTTACGACTTCCGG
HOXD13	CCAATAAAAA	TTTTTATTGG
HOXD13_2	CCCAATAAAAC	GTTTTATTGGG
HOXD3	CTAATTAC	GTAATTAG
HOXD4	ATCATTAG	CTAATGAT
HOXD4_2	TCATTA	TAATGA
HOXD8	GCAATTAC	GTAATTGC
HOXD8_2	GCAATTA	TAATTGC
HOXD9	GCAATAAAAC	GTTTTATTGC
HOXD9_2	GCAATAAAA	TTTTATTGC
HSF1	CTTCTAGAAGGTTCT	AGAACCTTCTAGAAG
HSF1_2	TTCTAGAACGTTC	GAACGTTCTAGAA
HSF2	TTCTAGAACGTTC	GAACGTTCTAGAA
HSF4	TTCTAGAACGTTC	GAACGTTCTAGAA
HSFY1	GTTCGAACGGTTCGAAC	GTTCGAACCGTTCGAAC
HSFY1_2	TTCGAACGGTTCGAA	TTCGAACCGTTCGAA
IKZF1	GAAACAGGAAGT	ACTTCCTGTTTC
IKZF1_2	AACAGGAA	TTCCTGTT
IKZF2	AGGAAG	CTTCCT
INSM1	TGTCAGGGGGCG	CGCCCCCTGACA
IRF1	GAAAGCGAAACC	GGTTTCGCTTTC
IRF1_2	TTTTACTTTCACTTTCACTTT	AAAGTGAAAGTGAAAGTAAAA
IRF2	GGAAAGCGAAACCAAAAC	GTTTTGGTTTCGCTTTCC
IRF2_2	GGAAAGCGAAACCAAA	TTTGGTTTCGCTTTCC
IRF3	GGGAAACGGAAACCGAAACTG	CAGTTTCGGTTTCCGTTTCCC
IRF3_2	GAAACGGAAACCGAAAC	GTTTCGGTTTCCGTTTC
IRF4	CCGAAACCGAAACTA	TAGTTTCGGTTTCGG
IRF4_2	CGAAACCGAAACTA	TAGTTTCGGTTTCG
IRF5	CCGAAACCGAAACT	AGTTTCGGTTTCGG
IRF6	ACCGAAACT	AGTTTCGGT
IRF7	ACGAAAGCGAAAGT	ACTTTCGCTTTCGT
IRF7_2	CGAAAGCGAAAGT	ACTTTCGCTTTCG
IRF8	TCGAAACCGAAACT	AGTTTCGGTTTCGA
IRF8_2	CGAAACCGAAACT	AGTTTCGGTTTCG
IRF9	AACGAAACCGAAACT	AGTTTCGGTTTCGTT
IRX3	TACATGAATATTCATGTA	TACATGAATATTCATGTA
ISL2	GCACTTAA	TTAAGTGC
ISL2_2	CACTTA	TAAGTG
ISX	CTAATTAA	TTAATTAG
ISX_2	TAATTA	TAATTA
JDP2	ATGACTCAT	ATGAGTCAT
JDP2_2	GATGACGTCATC	GATGACGTCATC
JDP2_3	ATGACGTCAT	ATGACGTCAT
JUN	AAGATGATGTCAT	ATGACATCATCTT
JUN_2	AGGAGATGACTCAT	ATGAGTCATCTCCT
JUN_3	ATGATGTCAT	ATGACATCAT
JUN::JUNB	GATGACTCAT	ATGAGTCATC
JUN::JUNB_2	TGTGACGTCATT	AATGACGTCACA
JUN::JUNB_3	ATGACTCA	TGAGTCAT
JUN::JUNB_4	TGTGACGTCAT	ATGACGTCACA
JUNB	GGATGACTCAT	ATGAGTCATCC
JUNB_2	ATGACGTCAT	ATGACGTCAT
JUNB_3	GATGACGTCATC	GATGACGTCATC
JUNB_4	AAATGACTCATTT	AAATGAGTCATTT
JUNB_5	ATGACGTCATC	GATGACGTCAT
JUNB_6	ATGACTCAT	ATGAGTCAT
JUND	GGTGACTCATC	GATGAGTCACC
JUND_2	AAAGATGATGTCATC	GATGACATCATCTTT
JUND_3	TGATGACTCATCC	GGATGAGTCATCA
JUND_4	GATGATGTCAT	ATGACATCATC
JUND_5	ATGACTCAT	ATGAGTCAT
KLF1	GGGGCGGGG	CCCCGCCCC
KLF1_2	GGGCGGGG	CCCCGCCC
KLF10	GCCACACCCCC	GGGGGTGTGGC
KLF10_2	GGGGCGGGG	CCCCGCCCC
KLF11	GCCACGCCCAC	GTGGGCGTGGC
KLF11_2	CCACGCCCAC	GTGGGCGTGG
KLF12	GGGGCGGGG	CCCCGCCCC
KLF13	ATGCCACGCCCCTTTTTG	CAAAAAGGGGCGTGGCAT
KLF13_2	TGCCACGCCCCTTTTTG	CAAAAAGGGGCGTGGCA
KLF14	GGCCACGCCCCCTT	AAGGGGGCGTGGCC
KLF14_2	GGGGCGGGG	CCCCGCCCC
KLF15	GCCCCGCCCCC	GGGGGCGGGGC
KLF15_2	CCCCGCCC	GGGCGGGG
KLF16	GCCACGCCCCC	GGGGGCGTGGC
KLF17	CACCACGCACCCCTT	AAGGGGTGCGTGGTG
KLF17_2	ACCACGCACCCCTT	AAGGGGTGCGTGGT
KLF2	CACCACGCCCA	TGGGCGTGGTG
KLF2_2	CCACGCCC	GGGCGTGG
KLF3	GACCACGCCCA	TGGGCGTGGTC
KLF3_2	GACCACGCCC	GGGCGTGGTC
KLF4	CCACACCCTGC	GCAGGGTGTGG
KLF4_2	CGCCCCACCCCC	GGGGGTGGGGCG
KLF4_3	CCCCACCC	GGGTGGGG
KLF5	GCCCCGCCCC	GGGGCGGGGC
KLF6	GGCCACGCCCA	TGGGCGTGGCC
KLF6_2	CCACGCCCA	TGGGCGTGG
KLF7	GGGGCGGGG	CCCCGCCCC
KLF7_2	GGGCGGGG	CCCCGCCC
KLF9	GGCCACACCCACC	GGTGGGTGTGGCC
KLF9_2	CAGCCACACCCACCCC	GGGGTGGGTGTGGCTG
KLF9_3	GCCACACCCAC	GTGGGTGTGGC
LBX1	TTAATTAG	CTAATTAA
LBX1_2	TAATTAG	CTAATTA
LBX2	GCCAATTAGC	GCTAATTGGC
LBX2_2	CAATTA	TAATTG
LEF1	AAAGATCAAAGGGTT	AACCCTTTGATCTTT
LHX1	GCAATTAC	GTAATTGC
LHX2	ACTAATTAAC	GTTAATTAGT
LHX2_2	AACCAATTAAT	ATTAATTGGTT
LHX2_3	CAATTA	TAATTG
LHX5	GTAATTAA	TTAATTAC
LHX5_2	GTAATTA	TAATTAC
LHX6	ACTAATTAGC	GCTAATTAGT
LHX6_2	CTAATTAG	CTAATTAG
LHX9	CCAATTAA	TTAATTGG
LHX9_2	CTAATTAA	TTAATTAG
LHX9_3	CTAATTA	TAATTAG
LMX1A	TTAATTAA	TTAATTAA
LMX1A_2	TTAATTAA	TTAATTAA
LMX1A_3	TTAATTA	TAATTAA
LMX1B	TTAATTAA	TTAATTAA
LMX1B_2	ATTTTAATTAA	TTAATTAAAAT
LMX1B_3	TTAATTAA	TTAATTAA
MAF	ATGCTGAGTCAGCAA	TTGCTGACTCAGCAT
MAF_2	TGCTGAGTCAGCA	TGCTGACTCAGCA
MAF::NFE2	ATGACTCAGCAATTT	AAATTGCTGAGTCAT
MAF::NFE2_2	ATGACTCAGCA	TGCTGAGTCAT
MAFA	TTGCTGAGTCAGCAA	TTGCTGACTCAGCAA
MAFA_2	TGCTGAGTCAGCA	TGCTGACTCAGCA
MAFF	GCTGAGTCAGCAATTTTT	AAAAATTGCTGACTCAGC
MAFF_2	AATTTGCTGAGTCAGCAAATT	AATTTGCTGACTCAGCAAATT
MAFF_3	AAGTCAGCATTTTTTT	AAAAAAATGCTGACTT
MAFF_4	GTCAGCATTTT	AAAATGCTGAC
MAFG	AAATTGCTGAGTCAGCATATT	AATATGCTGACTCAGCAATTT
MAFG_2	GAGTCAGCATTTTTT	AAAAAATGCTGACTC
MAFG::NFE2L1	AGAATGACTCAGCAAT	ATTGCTGAGTCATTCT
MAFG::NFE2L1_2	ATGACTCAGCA	TGCTGAGTCAT
MAFK	CTGAGTCAGCAATTT	AAATTGCTGACTCAG
MAFK_2	AATTGCTGAGTCAGCAAAT	ATTTGCTGACTCAGCAATT
MAFK_3	TGCTGACTCAGCAAT	ATTGCTGAGTCAGCA
MAFK_4	CTGACTCAGC	GCTGAGTCAG
MAX	AACCACGTGA	TCACGTGGTT
MAX_2	AAGCACATGG	CCATGTGCTT
MAX_3	ACCACGTGCT	AGCACGTGGT
MAX_4	CACGTG	CACGTG
MAX::MYC	GACCACGTGGT	ACCACGTGGTC
MAX::MYC_2	ACCACGTGGT	ACCACGTGGT
MAZ	CGCCCCTCCCC	GGGGAGGGGCG
MAZ_2	CCCCTCCC	GGGAGGGG
MEF2A	CTATTTATAG	CTATAAATAG
MEF2A_2	AGCTAAAAATAGCAT	ATGCTATTTTTAGCT
MEF2A_3	TCTAAAAATAGA	TCTATTTTTAGA
MEF2A_4	TTCTAAAAATAGAAA	TTTCTATTTTTAGAA
MEF2A_5	CTAAAAATAG	CTATTTTTAG
MEF2B	GCTATAAATAGC	GCTATTTATAGC
MEF2C	ATGCTAAAAATAGAA	TTCTATTTTTAGCAT
MEF2C_2	CTAAAAATAGA	TCTATTTTTAG
MEF2D	ACTATAAATAGA	TCTATTTATAGT
MEIS1	TTGACAG	CTGTCAA
MEIS1_2	GTCATCAATCATT	AATGATTGATGAC
MEIS1_3	TGACA	TGTCA
MEIS1_4	CATCAATCA	TGATTGATG
MEIS1::DRGX	TGTCAATTAA	TTAATTGACA
MEIS1::DRGX_2	TGTCAATTA	TAATTGACA
MEIS1::EVX1	TGACATCTAATCATTA	TAATGATTAGATGTCA
MEIS2	TTGACAGC	GCTGTCAA
MEIS2_2	AAATGATTTATGGCT	AGCCATAAATCATTT
MEIS2_3	TGATTTATG	CATAAATCA
MEIS3	TTGACAGG	CCTGTCAA
MEIS3_2	TTGACAG	CTGTCAA
MEOX1	GCTAATTAAC	GTTAATTAGC
MEOX1_2	CTAATTA	TAATTAG
MEOX2	AGTAATTAAC	GTTAATTACT
MEOX2_2	GTAATTA	TAATTAC
MESP2	CAACATATGGCG	CGCCATATGTTG
MGA	AGGTGTGA	TCACACCT
MGA::DLX2	AGGTGTTAATTG	CAATTAACACCT
MGA::DLX3	AGGTGTTAATTG	CAATTAACACCT
MGA::EVX1	AGGTGTTAATGA	TCATTAACACCT
MGA::EVX1_2	AGGTGTTAATG	CATTAACACCT
MITF	TAAGGTCACGTGACCTTA	TAAGGTCACGTGACCTTA
MITF_2	TAAAGTCACGTGACTTTA	TAAAGTCACGTGACTTTA
MITF_3	GTCACGTGAC	GTCACGTGAC
MIXL1	TCTAATTAAC	GTTAATTAGA
MIXL1_2	TAATTA	TAATTA
MLX	ATCACGTGAT	ATCACGTGAT
MLXIPL	ATCACGTGAT	ATCACGTGAT
MLXIPL_2	ATCACGTG	CACGTGAT
MNT	ACCACGTGCC	GGCACGTGGT
MNT_2	CACGTG	CACGTG
MNX1	GGTAATTAAA	TTTAATTACC
MNX1_2	GTAATTAT	ATAATTAC
MNX1_3	TAATTA	TAATTA
MSANTD3	GTACACTCAC	GTGAGTGTAC
MSANTD3_2	CACTCAC	GTGAGTG
MSC	AACAGCTGTT	AACAGCTGTT
MSGN1	CGCCATATGTCC	GGACATATGGCG
MSX1	CCAATTAG	CTAATTGG
MSX1_2	CCAATTAA	TTAATTGG
MSX1_3	CAATTA	TAATTG
MSX2	CCAATTAA	TTAATTGG
MSX2_2	CCAATTAA	TTAATTGG
MSX2_3	CAATTA	TAATTG
MTF1	TTTGCACACGGCAC	GTGCCGTGTGCAAA
MXD4	CCACGTGG	CCACGTGG
MXI1	CGACCACGTGCCC	GGGCACGTGGTCG
MXI1_2	GACACATGGC	GCCATGTGTC
MXI1_3	CACATG	CATGTG
MYB	ACCAACTGTC	GACAGTTGGT
MYB_2	CAACTG	CAGTTG
MYBL1	ACCGTTAACGGT	ACCGTTAACGGT
MYBL1::TBX21	AGGTGTGACCGTTG	CAACGGTCACACCT
MYBL2	AACCGTTAAACGGTC	GACCGTTTAACGGTT
MYC	GGCCACGTGCCC	GGGCACGTGGCC
MYC_2	CCACGTGC	GCACGTGG
MYCN	GGCCACGTGGCC	GGCCACGTGGCC
MYCN_2	CCACGTGG	CCACGTGG
MYF5	GAACAGCTGTTC	GAACAGCTGTTC
MYF5_2	ACAGCTGT	ACAGCTGT
MYF6	AACAGCTGTT	AACAGCTGTT
MYNN	AGGGACTCTTATTT	AAATAAGAGTCCCT
MYNN_2	GACTCTTAT	ATAAGAGTC
MYOD1	CAGCACCTGTCCC	GGGACAGGTGCTG
MYOD1_2	GCACCTGTC	GACAGGTGC
MYOG	CAGCAGCTGCTG	CAGCAGCTGCTG
MYOG_2	GCAGCTGC	GCAGCTGC
MZF1	TGGGGA	TCCCCA
MZF1_2	CAAATCCCCACTT	AAGTGGGGATTTG
MZF1_3	AATCCCCA	TGGGGATT
NANOG	ATTCCATTCCATTCCATT	AATGGAATGGAATGGAAT
NEUROD1	GGACAGATGGCAG	CTGCCATCTGTCC
NEUROD1_2	ACAGATGG	CCATCTGT
NEUROD2	GCCATATGGT	ACCATATGGC
NEUROG1	GACATATGTC	GACATATGTC
NEUROG2	AACATATGTC	GACATATGTT
NEUROG2_2	GGAACAGATGGCA	TGCCATCTGTTCC
NEUROG2_3	CAGATGG	CCATCTG
NFATC2	TTTTCCA	TGGAAAA
NFATC3	ATTTTCCATT	AATGGAAAAT
NFATC3_2	ATGGAAAAT	ATTTTCCAT
NFATC3_3	TGGAAA	TTTCCA
NFATC4	AATGGAAAAT	ATTTTCCATT
NFATC4_2	AATGGAAAAT	ATTTTCCATT
NFATC4_3	ATGGAAAAT	ATTTTCCAT
NFE2	CATGACTCATC	GATGAGTCATG
NFE2_2	ATGACTCATC	GATGAGTCAT
NFE2L2	ATGACTCAGCA	TGCTGAGTCAT
NFIA	GGTGCCAAGT	ACTTGGCACC
NFIA_2	TGCCAA	TTGGCA
NFIB	TGCCTGGCATTGTGCCAAGCA	TGCTTGGCACAATGCCAGGCA
NFIB_2	CCTGGCATTGTGCCAAG	CTTGGCACAATGCCAGG
NFIC	TTGGCA	TGCCAA
NFIC_2	TACTTGGCAGA	TCTGCCAAGTA
NFIC_3	GTTGGCACGGTGCCAAC	GTTGGCACCGTGCCAAC
NFIC_4	CTTGGCA	TGCCAAG
NFIC_5	TTGGCACGGTGCCAA	TTGGCACCGTGCCAA
NFIC::TLX1	TGGCACCATGCCAA	TTGGCATGGTGCCA
NFIL3	TTATGTAACAT	ATGTTACATAA
NFIL3_2	TATTATGCAATAT	ATATTGCATAATA
NFIL3_3	TTATGCAAT	ATTGCATAA
NFIX	CGTGCCAAG	CTTGGCACG
NFIX_2	GTTGGCACGGTGCCAGG	CCTGGCACCGTGCCAAC
NFIX_3	TGCCAA	TTGGCA
NFIX_4	TTGGCACGGTGCCA	TGGCACCGTGCCAA
NFKB1	GGGAATTTCC	GGAAATTCCC
NFKB1_2	GGGGATTCCCC	GGGGAATCCCC
NFKB1_3	GGGAATTTCCC	GGGAAATTCCC
NFKB1_4	AGGGGAATCCCCT	AGGGGATTCCCCT
NFKB2	AGGGGATTCCCCT	AGGGGAATCCCCT
NFKB2_2	GGGGATTCCCC	GGGGAATCCCC
NFYA	CTCAGCCAATCAGCGC	GCGCTGATTGGCTGAG
NFYA_2	AGAGTGCTGATTGGTCCA	TGGACCAATCAGCACTCT
NFYA_3	AACCAATCAGA	TCTGATTGGTT
NFYA_4	CCAATCAG	CTGATTGG
NFYB	AAATGGACCAATCAG	CTGATTGGTCCATTT
NFYB_2	CTCATTGGCCAG	CTGGCCAATGAG
NFYB_3	TCATTGGCC	GGCCAATGA
NFYC	AGCCAATCAGA	TCTGATTGGCT
NFYC_2	CCAATCA	TGATTGG
NHLH1	GCGCAGCTGCGT	ACGCAGCTGCGC
NHLH1_2	CGCAGCTGCG	CGCAGCTGCG
NHLH1_3	CGCAGCTGC	GCAGCTGCG
NHLH2	GGGCCGCAGCTGCGTCCC	GGGACGCAGCTGCGGCCC
NHLH2_2	GGCCGCAGCTGCGTCC	GGACGCAGCTGCGGCC
NKX2-2	TAACCACTCAAGAA	TTCTTGAGTGGTTA
NKX2-2_2	CCACTCAA	TTGAGTGG
NKX2-3	ACCACTTGAA	TTCAAGTGGT
NKX2-3_2	CCACTTGA	TCAAGTGG
NKX2-4	CCACTTGAAC	GTTCAAGTGG
NKX2-4_2	CCACTTGA	TCAAGTGG
NKX2-5	ACCACTCAAAA	TTTTGAGTGGT
NKX2-5_2	CACTCAA	TTGAGTG
NKX2-8	CCACTTGAA	TTCAAGTGG
NKX2-8_2	CCACTTGA	TCAAGTGG
NKX3-1	ATACTTA	TAAGTAT
NKX3-2	ACCACTTAA	TTAAGTGGT
NKX6-1	GTAATTAA	TTAATTAC
NKX6-1_2	TAATTAA	TTAATTA
NKX6-2	CTAATTAA	TTAATTAG
NKX6-2_2	TAATTA	TAATTA
NKX6-3	CTCATTAAA	TTTAATGAG
NKX6-3_2	CTCATTAA	TTAATGAG
NONO	CTCACC	GGTGAG
NOTO	GCTAATTAGC	GCTAATTAGC
NOTO_2	CTAATTA	TAATTAG
NR1D1	GGGTCAGTAGGTCAG	CTGACCTACTGACCC
NR1D1_2	GGGTCAGTAGGTCA	TGACCTACTGACCC
NR1D2	GGGTTAGTGGGTCAT	ATGACCCACTAACCC
NR1D2_2	TGGGTTAGTAGGTCA	TGACCTACTAACCCA
NR1H2::RXRA	AAAGGTCAAAGGTCAAC	GTTGACCTTTGACCTTT
NR1H4	TCAATGACCTA	TAGGTCATTGA
NR1H4::RXRA	GAGGTCATTGACCTT	AAGGTCAATGACCTC
NR1H4::RXRA_2	AGGTCATTGACCT	AGGTCAATGACCT
NR1I2	ATGAACTCGATGAACTC	GAGTTCATCGAGTTCAT
NR1I2_2	TGAACTCGATGAACT	AGTTCATCGAGTTCA
NR1I3	ATGAACTTT	AAAGTTCAT
NR1I3_2	TGAACTTT	AAAGTTCA
NR2C1	CGAGGTCAC	GTGACCTCG
NR2C1_2	AGGTCA	TGACCT
NR2C2	AGGGGTCAGAGGTCA	TGACCTCTGACCCCT
NR2C2_2	GAGGTCAT	ATGACCTC
NR2C2_3	GGGGTCAGAGGTCA	TGACCTCTGACCCC
NR2C2_4	AGGTCA	TGACCT
NR2F1	TGACCTTTGAACCT	AGGTTCAAAGGTCA
NR2F1_2	CAAAGGTCAAGGG	CCCTTGACCTTTG
NR2F1_3	GAGGTCAAAGGTCAC	GTGACCTTTGACCTC
NR2F1_4	AAGGTCATTGACCTT	AAGGTCAATGACCTT
NR2F1_5	AAAGGTCAAGGG	CCCTTGACCTTT
NR2F1_6	AGGTCAAAGGTCA	TGACCTTTGACCT
NR2F2	CAAAGGTCAAA	TTTGACCTTTG
NR2F2_2	AAGGTCA	TGACCTT
NR2F6	AAGGTCACTGACCTT	AAGGTCAGTGACCTT
NR3C1	GGGAACATTATGTCCTAA	TTAGGACATAATGTTCCC
NR3C1_2	GGGTACATAATGTTCCC	GGGAACATTATGTACCC
NR3C1_3	GGTACATAATGTTCC	GGAACATTATGTACC
NR3C2	GGGAACACAATGTTCCC	GGGAACATTGTGTTCCC
NR3C2_2	GGAACACAATGTTCC	GGAACATTGTGTTCC
NR4A1	AAAAGGTCAC	GTGACCTTTT
NR4A1_2	TTAAAGGTCAAA	TTTGACCTTTAA
NR4A1_3	AAAGGTCA	TGACCTTT
NR4A2	AAGGTCAC	GTGACCTT
NR4A2_2	TTAAAGGTCA	TGACCTTTAA
NR4A2_3	AAAGGTCA	TGACCTTT
NR4A2::RXRA	GAGGTCATTGACCCC	GGGGTCAATGACCTC
NR4A2::RXRA_2	AGGTCATTGACCC	GGGTCAATGACCT
NR5A1	GTCAAGGTCAC	GTGACCTTGAC
NR6A1	GTCAAGTTCAAGGTCAA	TTGACCTTGAACTTGAC
NR6A1_2	CAAGTTCAAGGTCA	TGACCTTGAACTTG
NRF1	GCGCCTGCGCA	TGCGCAGGCGC
NRL	AATTTGCTGAC	GTCAGCAAATT
NRL_2	AAAAGTGCTGACG	CGTCAGCACTTTT
NRL_3	AAAGTGCTGACG	CGTCAGCACTTT
OLIG1	AACATATGTT	AACATATGTT
OLIG2	ACCATATGGT	ACCATATGGT
OLIG3	ACCATATGTT	AACATATGGT
ONECUT1	AAAAAATCGATAAT	ATTATCGATTTTTT
ONECUT1_2	AAAAAATCAATAAATA	TATTTATTGATTTTTT
ONECUT1_3	AAATCAATA	TATTGATTT
ONECUT2	AAAAAATCGATAAT	ATTATCGATTTTTT
ONECUT2_2	CGATCGATA	TATCGATCG
ONECUT2_3	GATCGATA	TATCGATC
ONECUT3	AAAAAATCAATAAT	ATTATTGATTTTTT
ONECUT3_2	AAAAATCAATAA	TTATTGATTTTT
OSR1	TGCTACTGTT	AACAGTAGCA
OSR1_2	GCTACTGT	ACAGTAGC
OSR2	AAACAGAAGCAG	CTGCTTCTGTTT
OSR2_2	ACAGAAGC	GCTTCTGT
OTX1	TTAATCCG	CGGATTAA
OTX1_2	TAATCC	GGATTA
OTX2	TTAATCCT	AGGATTAA
OTX2_2	AAGGGATTAGAA	TTCTAATCCCTT
OTX2_3	GGGATTA	TAATCCC
OVOL1	AAAACCGTTATTTG	CAAATAACGGTTTT
OVOL1_2	AAACCGTTAT	ATAACGGTTT
OVOL2	GTACCGTTATGTG	CACATAACGGTAC
OVOL2_2	ACCGTTA	TAACGGT
OVOL3	GGACCGTTAG	CTAACGGTCC
PATZ1	GGGGGGCGGGGG	CCCCCGCCCCCC
PATZ1_2	GGGGGCGGGGG	CCCCCGCCCCC
PAX1	CGTCACGCATGACTGCA	TGCAGTCATGCGTGACG
PAX1_2	CGTCACGCATGACTGC	GCAGTCATGCGTGACG
PAX2	TCAGTGAAGCGTGACGA	TCGTCACGCTTCACTGA
PAX2_2	TCAGTGAAGCGTGACG	CGTCACGCTTCACTGA
PAX3	TAATCGATTA	TAATCGATTA
PAX3_2	CCGTCACGCTAATTAA	TTAATTAGCGTGACGG
PAX3_3	CGTCACGCTAATTA	TAATTAGCGTGACG
PAX4	CTAATTAG	CTAATTAG
PAX5	GAGGGCAGCCAAGCGTGAC	GTCACGCTTGGCTGCCCTC
PAX5_2	GAGCGTGACCCC	GGGGTCACGCTC
PAX5_3	GCGTGACC	GGTCACGC
PAX6	TTCACGCATGAGTT	AACTCATGCGTGAA
PAX7	TAATCGATTA	TAATCGATTA
PAX8	CGTCACGCATGACTGC	GCAGTCATGCGTGACG
PAX9	CGTCACGCATGACTGCA	TGCAGTCATGCGTGACG
PAX9_2	CGTCACGCATGACTGC	GCAGTCATGCGTGACG
PBX1	CCATCAATCAAA	TTTGATTGATGG
PBX1_2	ATCAATCAA	TTGATTGAT
PBX2	GTGATTGACAGG	CCTGTCAATCAC
PBX2_2	GTCATAAATCATT	AATGATTTATGAC
PBX2_3	CATAAATCA	TGATTTATG
PBX3	GGGTGAGTGACAGGCGG	CCGCCTGTCACTCACCC
PBX3_2	TGAGTGACAGG	CCTGTCACTCA
PBX4	ATGAGTCAT	ATGACTCAT
PDX1	GTAATTAG	CTAATTAC
PDX1_2	TAATTA	TAATTA
PGR	ACAGTCTGT	ACAGACTGT
PHOX2A	TAATTTAATTA	TAATTAAATTA
PHOX2B	TTTAATCAAATTATAT	ATATAATTTGATTAAA
PHOX2B_2	TAATCAAATTAT	ATAATTTGATTA
PITX1	CTAATCCC	GGGATTAG
PITX1_2	TAATCC	GGATTA
PITX1::HES7	ACACGTGGGGGATTA	TAATCCCCCACGTGT
PITX1::TBX21	AGGTGTGAAGGGATTA	TAATCCCTTCACACCT
PITX2	ATAATCCC	GGGATTAT
PITX2_2	TTAATCCC	GGGATTAA
PITX3	CTTAATCCC	GGGATTAAG
PITX3_2	TAATCC	GGATTA
PKNOX1	TGACAGGTGTCA	TGACACCTGTCA
PKNOX1_2	TTTGAGTGACAGCTA	TAGCTGTCACTCAAA
PKNOX1_3	TGAGTGACAG	CTGTCACTCA
PKNOX2	TGACAGGTGTCA	TGACACCTGTCA
PLAG1	GGGGCCCAAGGGGG	CCCCCTTGGGCCCC
PLAGL2	TGGGCCCCCT	AGGGGGCCCA
PLAGL2_2	GGGCCCCC	GGGGGCCC
POU1F1	AATATGCAAATTAG	CTAATTTGCATATT
POU1F1_2	AGCTAATTTGCATAAT	ATTATGCAAATTAGCT
POU1F1_3	CTAATTTGCATAAT	ATTATGCAAATTAG
POU2F1	AATATGCAAATT	AATTTGCATATT
POU2F1_2	TATGCAAAT	ATTTGCATA
POU2F1::DLX2	ATTTGCATATCTAATTG	CAATTAGATATGCAAAT
POU2F1::ELK1	ACCGGATATGCAA	TTGCATATCCGGT
POU2F1::ETV1	ACCGGATATGCAT	ATGCATATCCGGT
POU2F1::ETV1_2	ACCGGATATGCA	TGCATATCCGGT
POU2F1::SOX2	AATTTGCATAACAATGG	CCATTGTTATGCAAATT
POU2F2	TTCATTTGCATAT	ATATGCAAATGAA
POU2F2_2	AATATGCAAATTAG	CTAATTTGCATATT
POU2F2_3	ATATGCAAATTAG	CTAATTTGCATAT
POU2F3	AATATGCAAATAA	TTATTTGCATATT
POU2F3_2	TATGCAAAT	ATTTGCATA
POU3F1	TTATGCAAATTA	TAATTTGCATAA
POU3F1_2	TTATGCAAAT	ATTTGCATAA
POU3F2	TTATGCAAATTA	TAATTTGCATAA
POU3F3	ATTATGCTAATTT	AAATTAGCATAAT
POU3F4	TATGCAAAT	ATTTGCATA
POU4F1	ATGAATAATTAATG	CATTAATTATTCAT
POU4F1_2	TGAATAATTAAT	ATTAATTATTCA
POU4F2	ATGCATAATTAATGAG	CTCATTAATTATGCAT
POU4F2_2	TGCATAATTAATGAG	CTCATTAATTATGCA
POU4F3	ATGCATAATTAATGAG	CTCATTAATTATGCAT
POU4F3_2	TGCATAATTAAT	ATTAATTATGCA
POU5F1	ATATGCAAATT	AATTTGCATAT
POU5F1_2	ATGCAAA	TTTGCAT
POU5F1B	TATGCAAAT	ATTTGCATA
POU6F1	ATTAATTAAT	ATTAATTAAT
POU6F1_2	ATAATGAGGT	ACCTCATTAT
POU6F1_3	TAATTA	TAATTA
POU6F1_4	TAATGAG	CTCATTA
POU6F2	AGCTCATTAT	ATAATGAGCT
POU6F2_2	AGCTCATTA	TAATGAGCT
PPARA::RXRA	ATGTAGGTCAAAGGTCAT	ATGACCTTTGACCTACAT
PPARA::RXRA_2	ATGTAGGTCAAAGGTCA	TGACCTTTGACCTACAT
PPARD	AGGGGTCAAAGGTCAA	TTGACCTTTGACCCCT
PPARD_2	GGGGTCAAAGGTCA	TGACCTTTGACCCC
PPARG	GTAGGTCACGGTGACCTACT	AGTAGGTCACCGTGACCTAC
PPARG_2	TAGGTCACGGTGACCTACT	AGTAGGTCACCGTGACCTA
PPARG::RXRA	CCAGGGGTCAAAGGTCATCG	CGATGACCTTTGACCCCTGG
PRDM1	AGAAAGTGAAAGTGA	TCACTTTCACTTTCT
PRDM1_2	TCACTTTCAC	GTGAAAGTGA
PRDM1_3	TTCTTTCTCTT	AAGAGAAAGAA
PRDM1_4	CTTTCTC	GAGAAAG
PRDM4	GTCTGTTTCTA	TAGAAACAGAC
PRDM9	GGTGGGCAGGGAGGAAGCAGAAGG	CCTTCTGCTTCCTCCCTGCCCACC
PRDM9_2	GGTGGGCAGGGAGGAAGCAG	CTGCTTCCTCCCTGCCCACC
PROP1	TAATTTAATTA	TAATTAAATTA
PROX1	CAAGACGCCTTA	TAAGGCGTCTTG
PRRX1	CTAATTAA	TTAATTAG
PRRX1_2	TAATTA	TAATTA
PRRX2	CTAATTAA	TTAATTAG
PRRX2_2	CTAATTA	TAATTAG
RARA	GAGGTCAAAAGGTCAATG	CATTGACCTTTTGACCTC
RARA_2	AGGTCATGCAAAGGTCA	TGACCTTTGCATGACCT
RARA::RXRA	AGGTCACGGAGAGGTCA	TGACCTCTCCGTGACCT
RARA::RXRG	GAGGTCATGTAGAGGTCA	TGACCTCTACATGACCTC
RARA::RXRG_2	AGGTCATGTAGAGGTCA	TGACCTCTACATGACCT
RARB	AAGGTCATGACCTT	AAGGTCATGACCTT
RARB_2	AAGGTCATGACCT	AGGTCATGACCTT
RARG	AAGGTCATGACCTT	AAGGTCATGACCTT
RARG_2	AGGTCATGACCTT	AAGGTCATGACCT
RAX	GCCAATTAAC	GTTAATTGGC
RAX_2	CAATTA	TAATTG
RAX2	CCAATTAA	TTAATTGG
RAX2_2	CAATTA	TAATTG
RBPJ	CCTGGGAAAG	CTTTCCCAGG
RBPJ_2	TGGGAA	TTCCCA
REL	GGGGATTTCC	GGAAATCCCC
RELA	GGGAATTTCC	GGAAATTCCC
RELB	GAATTCCCCGG	CCGGGGAATTC
RELB_2	ATTCCCC	GGGGAAT
REST	GCGCTGTCCATGGTGCTGA	TCAGCACCATGGACAGCGC
REST_2	TTCAGCACCATGGACAGCGCC	GGCGCTGTCCATGGTGCTGAA
REST_3	TCAGCACCATGGACAGCGCC	GGCGCTGTCCATGGTGCTGA
RFX1	CTGTTGCTATGGCA	TGCCATAGCAACAG
RFX1_2	CGTTGCCATGGCAACG	CGTTGCCATGGCAACG
RFX2	GTTGCCATGGCAACCGCGG	CCGCGGTTGCCATGGCAAC
RFX2_2	CGTTGCCATGGCAACG	CGTTGCCATGGCAACG
RFX2_3	GTTGCCATGGCAAC	GTTGCCATGGCAAC
RFX3	CGTTGCCATGGCAACG	CGTTGCCATGGCAACG
RFX3_2	CGGTTGCTATGGCA	TGCCATAGCAACCG
RFX3_3	CGTTGCCATGGCAACG	CGTTGCCATGGCAACG
RFX4	CGTTGCCATGGCAACG	CGTTGCCATGGCAACG
RFX4_2	CCGTTGCTTAGCAACGG	CCGTTGCTAAGCAACGG
RFX4_3	GTTGCTTAGCAAC	GTTGCTAAGCAAC
RFX5	CTCCCTGGCAACAGC	GCTGTTGCCAGGGAG
RFX5_2	CGTTGCCATGGCAACG	CGTTGCCATGGCAACG
RFX5_3	GTTGCCATGGCAAC	GTTGCCATGGCAAC
RFX7	CGTTGCTAT	ATAGCAACG
RFX7_2	CGTTGCTA	TAGCAACG
RHOXF1	ATAATCCC	GGGATTAT
RHOXF1_2	TAATCC	GGATTA
RHOXF2	CTAATCCC	GGGATTAG
RHOXF2_2	TAATCC	GGATTA
RORA	ATCAAGGTCA	TGACCTTGAT
RORA_2	TATAAGTAGGTCAA	TTGACCTACTTATA
RORA_3	TAAGTAGGTCA	TGACCTACTTA
RORB	AATTAGGTCAC	GTGACCTAATT
RORB_2	AATTAGGTCA	TGACCTAATT
RORC	ATAAGTAGGTCA	TGACCTACTTAT
RORC_2	AAGTAGGTCA	TGACCTACTT
RREB1	CCCCAAACCACCCCCCCCCA	TGGGGGGGGGTGGTTTGGGG
RREB1_2	CCCCAAACCACCCCCCCCC	GGGGGGGGGTGGTTTGGGG
RUNX1	TATTGTGGTTA	TAACCACAATA
RUNX2	GGGGTTTGTGGTTTG	CAAACCACAAACCCC
RUNX2_2	AAACCGCAA	TTGCGGTTT
RUNX3	AAACCGCAAA	TTTGCGGTTT
RUNX3_2	AAAACCTCAAAT	ATTTGAGGTTTT
RUNX3_3	AACCTCAA	TTGAGGTT
RXRA::VDR	GGGTCAACGAGTTCA	TGAACTCGTTGACCC
RXRB	GGGGTCAAAGGTCA	TGACCTTTGACCCC
RXRB_2	GAGGTCATGACCTC	GAGGTCATGACCTC
RXRG	GGGGTCAAAGGTCA	TGACCTTTGACCCC
RXRG_2	GAGGTCATGACCTC	GAGGTCATGACCTC
SATB1	TTACTAATAACTA	TAGTTATTAGTAA
SATB1_2	CTAATAA	TTATTAG
SCRT1	GAGCAACAGGTGGTT	AACCACCTGTTGCTC
SCRT1_2	AATTCAACAGGTGGTT	AACCACCTGTTGAATT
SCRT1_3	TCAACAGGTG	CACCTGTTGA
SCRT2	ATGCAACAGGTGG	CCACCTGTTGCAT
SCRT2_2	AAAGCAACAGGTGGTT	AACCACCTGTTGCTTT
SCRT2_3	GCAACAGGTG	CACCTGTTGC
SHOX	TTAATTGG	CCAATTAA
SHOX_2	TAATTG	CAATTA
SIX1	GTAACCTGATA	TATCAGGTTAC
SIX1_2	GTAACCTGA	TCAGGTTAC
SIX2	AACTGAAACCTGATAC	GTATCAGGTTTCAGTT
SIX2_2	TGAAACCTGAT	ATCAGGTTTCA
SMAD2	TGCCAGACAG	CTGTCTGGCA
SMAD2_2	CCAGAC	GTCTGG
SMAD3	CGTCTAGACA	TGTCTAGACG
SMAD5	TGTCTAGACA	TGTCTAGACA
SNAI1	GGCAGGTGCA	TGCACCTGCC
SNAI1_2	GCAGGTG	CACCTGC
SNAI2	AACAGGTGT	ACACCTGTT
SNAI2_2	ATGCACCTGTCAT	ATGACAGGTGCAT
SNAI2_3	GCACCTGT	ACAGGTGC
SNAI3	AACAGGTGCA	TGCACCTGTT
SNAI3_2	ACAGGTGCA	TGCACCTGT
SOHLH2	CGCACGTGCA	TGCACGTGCG
SOHLH2_2	GCACGTGC	GCACGTGC
SOX10	CTTTGT	ACAAAG
SOX10_2	AAAACAAAGAA	TTCTTTGTTTT
SOX10_3	ACAAAG	CTTTGT
SOX12	ACCGAACAATG	CATTGTTCGGT
SOX12_2	ACCGAACAAT	ATTGTTCGGT
SOX13	AAACAATGGCA	TGCCATTGTTT
SOX13_2	ACAATGG	CCATTGT
SOX14	CCGAACAATG	CATTGTTCGG
SOX14_2	CGAACAATG	CATTGTTCG
SOX15	CTATTGTTTT	AAAACAATAG
SOX15_2	CTATTGT	ACAATAG
SOX18	CACAATGC	GCATTGTG
SOX18_2	AACAATTC	GAATTGTT
SOX2	AAACAATGGAA	TTCCATTGTTT
SOX2_2	ACAATGG	CCATTGT
SOX21	AACAATGGTAGTGTT	AACACTACCATTGTT
SOX4	GAACAATTGCAGTGTT	AACACTGCAATTGTTC
SOX4_2	GAACAAAGGG	CCCTTTGTTC
SOX4_3	AACAAAGG	CCTTTGTT
SOX8	AACAATGTGCAGTGTT	AACACTGCACATTGTT
SOX8_2	AGAACAATGG	CCATTGTTCT
SOX8_3	AACAATG	CATTGTT
SOX9	CCATTGTTC	GAACAATGG
SOX9_2	CCATTGTT	AACAATGG
SP1	GGGGCGGGGT	ACCCCGCCCC
SP1_2	CCCCGCCCCC	GGGGGCGGGG
SP1_3	GCCCCGCCCCC	GGGGGCGGGGC
SP1_4	TAAGCCACGCCCACT	AGTGGGCGTGGCTTA
SP1_5	GGGGCGGGG	CCCCGCCCC
SP2	GCCCCGCCCCCTCCC	GGGAGGGGGCGGGGC
SP2_2	CTAAGCCCCGCCCACTT	AAGTGGGCGGGGCTTAG
SP2_3	GGGGCGGGG	CCCCGCCCC
SP3	GCCACGCCCCC	GGGGGCGTGGC
SP3_2	GGCCACGCCCACC	GGTGGGCGTGGCC
SP3_3	GCCACGCCCAC	GTGGGCGTGGC
SP4	TAAGCCACGCCCCCTTT	AAAGGGGGCGTGGCTTA
SP4_2	GGGGCGGGG	CCCCGCCCC
SP5	CCCCTCCCCC	GGGGGAGGGG
SP5_2	CCTCCC	GGGAGG
SP8	GCCACGCCCACT	AGTGGGCGTGGC
SP8_2	CCACGCCCACT	AGTGGGCGTGG
SP9	GCCACGCCCCCC	GGGGGGCGTGGC
SP9_2	CCACGCCCCC	GGGGGCGTGG
SPDEF	ACCCGGATGTA	TACATCCGGGT
SPDEF_2	ACCCGGATGT	ACATCCGGGT
SPI1	CGGAAG	CTTCCG
SPI1_2	AGGAAGT	ACTTCCT
SPI1_3	AAAAAGCGGAAGTA	TACTTCCGCTTTTT
SPI1_4	AAAAAAGAGGAAGTGAAAAA	TTTTTCACTTCCTCTTTTTT
SPIB	AGAGGAA	TTCCTCT
SPIB_2	TTTCACTTCCTCTTTT	AAAAGAGGAAGTGAAA
SPIB_3	TCACTTCCTCTTT	AAAGAGGAAGTGA
SPIC	AAAAAGAGGAAGTA	TACTTCCTCTTTTT
SPIC_2	AAAAGAGGAAGTA	TACTTCCTCTTTT
SREBF1	ATCACCCCAC	GTGGGGTGAT
SREBF1_2	AGATCACCTGATCT	AGATCAGGTGATCT
SREBF1_3	ATCACCTGAT	ATCAGGTGAT
SREBF2	ATGGGGTGAT	ATCACCCCAT
SREBF2_2	ATCACGTGAC	GTCACGTGAT
SREBF2_3	TTATCACGTGATAA	TTATCACGTGATAA
SREBF2_4	ATCACGTGAT	ATCACGTGAT
SRF	GCCCATATATGG	CCATATATGGGC
SRF_2	CATGCCCAAATAAGGCAA	TTGCCTTATTTGGGCATG
SRF_3	TGACCATATATGGTCA	TGACCATATATGGTCA
SRY	GTAAACAAT	ATTGTTTAC
SRY_2	AAACAAT	ATTGTTT
STAT1	GGAAAACGAAACTG	CAGTTTCGTTTTCC
STAT1_2	CATTTCCCGGAAACC	GGTTTCCGGGAAATG
STAT1_3	TTTCCAGGAAA	TTTCCTGGAAA
STAT1_4	TTCCAGGAA	TTCCTGGAA
STAT1::STAT2	TCAGTTTCATTTTCC	GGAAAATGAAACTGA
STAT1::STAT2_2	AGTTTCATTTTCC	GGAAAATGAAACT
STAT3	CTTCTGGGAAA	TTTCCCAGAAG
STAT3_2	TTCTGGGAA	TTCCCAGAA
TAL1	GCACCTGG	CCAGGTGC
TAL1::TCF3	CGACCATCTGTT	AACAGATGGTCG
TAL1::TCF3_2	ACCATCTGTT	AACAGATGGT
TBR1	AGGTGTGAAA	TTTCACACCT
TBR1_2	AGGTGTGAA	TTCACACCT
TBX1	AGGTGTGA	TCACACCT
TBX15	AGGTGTGA	TCACACCT
TBX18	GGAGGTGTGAAA	TTTCACACCTCC
TBX18_2	AGGTGTGAA	TTCACACCT
TBX19	TTTCACACCTAGGTGTGAAA	TTTCACACCTAGGTGTGAAA
TBX19_2	TCACACCTAGGTGTGAA	TTCACACCTAGGTGTGA
TBX2	AAGGTGTGAAA	TTTCACACCTT
TBX2_2	AGGTGTGAA	TTCACACCT
TBX20	TAGGTGTGAAG	CTTCACACCTA
TBX21	AAGGTGTGAA	TTCACACCTT
TBX21_2	TTTCACACCTT	AAGGTGTGAAA
TBX21_3	TTCACACCTT	AAGGTGTGAA
TBX3	GAGGTGTGAA	TTCACACCTC
TBX3_2	AAGGTGTGAAA	TTTCACACCTT
TBX3_3	AGGTGTGAA	TTCACACCT
TBX4	AGGTGTGA	TCACACCT
TBX5	AGGTGTGA	TCACACCT
TBX6	GAGGTGTGAA	TTCACACCTC
TBXT	TCACACCTAGGTGTGA	TCACACCTAGGTGTGA
TCF12	CGCACCTGCCG	CGGCAGGTGCG
TCF12_2	CACCTGC	GCAGGTG
TCF15	AACACATGGT	ACCATGTGTT
TCF15_2	ACACATG	CATGTGT
TCF21	CACCATATGGCG	CGCCATATGGTG
TCF21_2	ACCATATGGC	GCCATATGGT
TCF3	AACACCTGCT	AGCAGGTGTT
TCF3_2	CGCACCTGCCC	GGGCAGGTGCG
TCF3_3	CACCTGC	GCAGGTG
TCF4	CGCACCTGCT	AGCAGGTGCG
TCF4_2	CGGCACCTGCCCC	GGGGCAGGTGCCG
TCF4_3	GCACCTGC	GCAGGTGC
TCF7	TCCTTTGATGT	ACATCAAAGGA
TCF7_2	CTTTGAT	ATCAAAG
TCF7L1	AAAGATCAAAGG	CCTTTGATCTTT
TCF7L2	AAAGATCAAAGGAA	TTCCTTTGATCTTT
TCF7L2_2	AGATCAAAG	CTTTGATCT
TCFL5	TCACGCGCAC	GTGCGCGTGA
TCFL5_2	TCACGCGC	GCGCGTGA
TEAD1	CACATTCCTCCG	CGGAGGAATGTG
TEAD1_2	CACATTCCAT	ATGGAATGTG
TEAD1_3	CCACATTCCAGGC	GCCTGGAATGTGG
TEAD1_4	ACATTCCAG	CTGGAATGT
TEAD2	TCACATTCCAGCC	GGCTGGAATGTGA
TEAD2_2	ACATTCC	GGAATGT
TEAD3	ACATTCCA	TGGAATGT
TEAD4	CACATTCCAT	ATGGAATGTG
TEAD4_2	CCACATTCCAGG	CCTGGAATGTGG
TEAD4_3	ACATTCCA	TGGAATGT
TEAD4::DRGX	GGAATGTTAATTG	CAATTAACATTCC
TEAD4::DRGX_2	GGAATGTTAATT	AATTAACATTCC
TEAD4::ELF1	GGAATGCGGAAGTA	TACTTCCGCATTCC
TEAD4::ELF1_2	GGAATGCGGAAGT	ACTTCCGCATTCC
TEAD4::ELK1	GGAATCCGGAAGTG	CACTTCCGGATTCC
TEAD4::ELK1_2	GGAATCCGGAAGT	ACTTCCGGATTCC
TEAD4::ETV7	GGAATGCGGAAGTACTTCCG	CGGAAGTACTTCCGCATTCC
TEAD4::ETV7_2	GGAATGCGGAAGTACTTCC	GGAAGTACTTCCGCATTCC
TEAD4::SPDEF	GGAATGCGGATGT	ACATCCGCATTCC
TEAD4::SPDEF_2	GGAATGCGGAT	ATCCGCATTCC
TEAD4::SPIB	GGAATGCGGAAGTA	TACTTCCGCATTCC
TEAD4::SPIB_2	GGAATGCGGAAGT	ACTTCCGCATTCC
TEF	TATTACGTAACA	TGTTACGTAATA
TEF_2	ATTACGTAAC	GTTACGTAAT
TFAP2A	GCCCGGGGG	CCCCCGGGC
TFAP2A_2	CATTGCCTCAGGGCA	TGCCCTGAGGCAATG
TFAP2A_3	TGCCCCCGGGCA	TGCCCGGGGGCA
TFAP2A_4	CGCCTCAGGCA	TGCCTGAGGCG
TFAP2A_5	TGCCCTGAGGGCA	TGCCCTCAGGGCA
TFAP2A_6	ATTGCCTCAGGCCA	TGGCCTGAGGCAAT
TFAP2A_7	TGCCCCCGGGC	GCCCGGGGGCA
TFAP2A_8	GCCTCAGGC	GCCTGAGGC
TFAP2B	TGCCCCAGGGCA	TGCCCTGGGGCA
TFAP2B_2	AGCCTCAGGCA	TGCCTGAGGCT
TFAP2B_3	TGCCCTGAGGGCA	TGCCCTCAGGGCA
TFAP2B_4	GCCCCAGGGCA	TGCCCTGGGGC
TFAP2B_5	GCCTCAGGC	GCCTGAGGC
TFAP2C	CATGGCCCCAGGGCA	TGCCCTGGGGCCATG
TFAP2C_2	TGCCCCAGGGCA	TGCCCTGGGGCA
TFAP2C_3	AGCCTCAGGCA	TGCCTGAGGCT
TFAP2C_4	TGCCCTGAGGGCA	TGCCCTCAGGGCA
TFAP2C_5	GGGCCTGAGGCGGG	CCCGCCTCAGGCCC
TFAP2C_6	GCCCCAGGGCA	TGCCCTGGGGC
TFAP2C_7	GCCTGAGGC	GCCTCAGGC
TFAP2E	CGCCTCAGGCG	CGCCTGAGGCG
TFAP2E_2	GCCTCAGGC	GCCTGAGGC
TFAP4	AACAGCTGAT	ATCAGCTGTT
TFAP4_2	AACATATGTT	AACATATGTT
TFAP4::ETV1	GCCGGAAGCAGGTGGG	CCCACCTGCTTCCGGC
TFAP4::ETV1_2	CCGGAAGCAGGTG	CACCTGCTTCCGG
TFAP4::FLI1	ACCGGAAACAGCTGAT	ATCAGCTGTTTCCGGT
TFAP4::FLI1_2	ACCGGAAACAGCTG	CAGCTGTTTCCGGT
TFCP2	AAACCGGTTT	AAACCGGTTT
TFCP2_2	AAACCGGTT	AACCGGTTT
TFDP1	GGGCGGGAAGG	CCTTCCCGCCC
TFDP1_2	GGCGGGAA	TTCCCGCC
TFE3	ATCACGTGAC	GTCACGTGAT
TFE3_2	CACGTGAC	GTCACGTG
TFE3_3	GTCACGTGAC	GTCACGTGAC
TFEB	ATCACGTGAC	GTCACGTGAT
TFEB_2	CACGTGAC	GTCACGTG
TFEC	ATCACGTGAC	GTCACGTGAT
TFEC_2	CCCACGTGACC	GGTCACGTGGG
TFEC_3	CACGTGAC	GTCACGTG
TGIF1	TGACAGCTGTCA	TGACAGCTGTCA
TGIF2	TGACAGCTGTCA	TGACAGCTGTCA
TGIF2LX	TGACAGCTGTCA	TGACAGCTGTCA
TGIF2LY	TGACAGCTGTCA	TGACAGCTGTCA
THAP1	CTGCCCGCA	TGCGGGCAG
THAP1_2	GCGCAGGGCAGG	CCTGCCCTGCGC
THAP1_3	GCAGGGCA	TGCCCTGC
THAP11	AGGACTACATTTCCCAGCA	TGCTGGGAAATGTAGTCCT
THAP5	CCATTGGCT	AGCCAATGG
THRA	CCTGTGTCCTCATGTGACCTCTCC	GGAGAGGTCACATGAGGACACAGG
THRA_2	GTGTCCTCATGTGACCTC	GAGGTCACATGAGGACAC
THRB	GGGGTCAAAGGTCAT	ATGACCTTTGACCCC
THRB_2	GTGACCTCATTGAGGTCAC	GTGACCTCAATGAGGTCAC
THRB_3	GTGACCTTACGTGACCTTA	TAAGGTCACGTAAGGTCAC
THRB_4	GGGTCAAAGGTCA	TGACCTTTGACCC
THRB_5	TGACCTCATTGAGGTCA	TGACCTCAATGAGGTCA
THRB_6	TGACCTTACGTGACCTTA	TAAGGTCACGTAAGGTCA
TLX2	CTAATTAG	CTAATTAG
TLX2_2	TAATTA	TAATTA
TP53	CCGGACATGCCCGGGCATGT	ACATGCCCGGGCATGTCCGG
TP53_2	ACATGCCCAGACATG	CATGTCTGGGCATGT
TP53_3	AACATGCCCGGGCATGTC	GACATGCCCGGGCATGTT
TP63	AGACATGCCCAGACATGCCC	GGGCATGTCTGGGCATGTCT
TP63_2	AACATGTTGGGACATGTC	GACATGTCCCAACATGTT
TP73	GACATGTCTGGACATGTC	GACATGTCCAGACATGTC
TP73_2	ACATGTCTGGACATGT	ACATGTCCAGACATGT
TRPS1	TATCTTATCTTT	AAAGATAAGATA
TRPS1_2	TCTTATCT	AGATAAGA
TWIST1	ATTCCAGATGTTT	AAACATCTGGAAT
TWIST1_2	ATTCCAGATGTTT	AAACATCTGGAAT
TWIST1_3	CCAGATGT	ACATCTGG
UNCX	CTAATTAA	TTAATTAG
UNCX_2	TAATTA	TAATTA
USF1	CACGTGG	CCACGTG
USF1_2	GCCACGTGACC	GGTCACGTGGC
USF1_3	TGGTCATGTGACCT	AGGTCACATGACCA
USF1_4	GTCATGTGAC	GTCACATGAC
USF2	GTCATGTGACC	GGTCACATGAC
USF2_2	CGGGGTCACGTGGCCC	GGGCCACGTGACCCCG
USF2_3	TGGTCATGTGACCT	AGGTCACATGACCA
USF2_4	GGTCACGTGACC	GGTCACGTGACC
USF2_5	GTCACGTGAC	GTCACGTGAC
VAX1	CTAATTAC	GTAATTAG
VAX1_2	CTAATTA	TAATTAG
VAX2	CTAATTAC	GTAATTAG
VAX2_2	GTAATTAG	CTAATTAC
VAX2_3	TAATTA	TAATTA
VDR	TGAGTTCA	TGAACTCA
VENTX	ACCGATTAG	CTAATCGGT
VEZF1	CCCCCCACTT	AAGTGGGGGG
VEZF1_2	CCCCCC	GGGGGG
VSX1	CTAATTAT	ATAATTAG
VSX1_2	CTAATTA	TAATTAG
VSX2	CTAATTAG	CTAATTAG
VSX2_2	CTAATTA	TAATTAG
XBP1	AATGCCACGTCATC	GATGACGTGGCATT
XBP1_2	GCCACGTCATC	GATGACGTGGC
YBX1	TGTACCATC	GATGGTACA
YY1	GCCATC	GATGGC
YY1_2	CAAGATGGCGGC	GCCGCCATCTTG
YY2	GTCCGCCATTA	TAATGGCGGAC
YY2_2	AGATGGCGGCG	CGCCGCCATCT
YY2_3	ATGGCGG	CCGCCAT
ZBED1	CTATCGCGACATA	TATGTCGCGATAG
ZBED1_2	TATCGCGACATA	TATGTCGCGATA
ZBED2	GCAACGAAACCAGG	CCTGGTTTCGTTGC
ZBED2_2	CGAAACC	GGTTTCG
ZBED4	CCCGCCCCGC	GCGGGGCGGG
ZBTB11	CACTTCCGG	CCGGAAGTG
ZBTB12	ATCTGGAACCC	GGGTTCCAGAT
ZBTB12_2	CTGGAAC	GTTCCAG
ZBTB14	CCCCGCGCACCC	GGGTGCGCGGGG
ZBTB14_2	CCGCGCAC	GTGCGCGG
ZBTB17	AATCGATT	AATCGATT
ZBTB18	CATCCAGATGTTC	GAACATCTGGATG
ZBTB18_2	ATCCAGATGTT	AACATCTGGAT
ZBTB20	TTAATGTATAGA	TCTATACATTAA
ZBTB20_2	AATGTATAG	CTATACATT
ZBTB21	TGACCTCATC	GATGAGGTCA
ZBTB21_2	ACCTCA	TGAGGT
ZBTB22	TTCACTATAATAGTGAA	TTCACTATTATAGTGAA
ZBTB22_2	TCACTATAATAGTGA	TCACTATTATAGTGA
ZBTB24	CCCAGGACCC	GGGTCCTGGG
ZBTB26	TACTCCAGAAAAGAT	ATCTTTTCTGGAGTA
ZBTB26_2	CTCCAGAA	TTCTGGAG
ZBTB32	TGTACAGTAT	ATACTGTACA
ZBTB33	CTCTCGCGAGATCTG	CAGATCTCGCGAGAG
ZBTB33_2	TCTCGCGAGA	TCTCGCGAGA
ZBTB37	ATGCCGTATTAGCCGAT	ATCGGCTAATACGGCAT
ZBTB37_2	TGCCGTATTAGCCGA	TCGGCTAATACGGCA
ZBTB40	AAAACTTTATTTA	TAAATAAAGTTTT
ZBTB40_2	AAAACTTTATT	AATAAAGTTTT
ZBTB42	TCCAGATGTGGG	CCCACATCTGGA
ZBTB42_2	CAGATGTG	CACATCTG
ZBTB43	AGTGCCATAAAGGCAGCACT	AGTGCTGCCTTTATGGCACT
ZBTB43_2	GTGCCATAAAGGCAGCAC	GTGCTGCCTTTATGGCAC
ZBTB44	TGGATGCATCT	AGATGCATCCA
ZBTB44_2	GATGCATC	GATGCATC
ZBTB45	TCACCTATAGA	TCTATAGGTGA
ZBTB45_2	CCTATAG	CTATAGG
ZBTB48	CTGCCTCAGC	GCTGAGGCAG
ZBTB6	GTCCTTGAGCCCG	CGGGCTCAAGGAC
ZBTB6_2	CCTTGAGCC	GGCTCAAGG
ZBTB7A	GGCGACCACCGA	TCGGTGGTCGCC
ZBTB7A_2	GCCCGGAAGTGGC	GCCACTTCCGGGC
ZBTB7A_3	CCGGAAGTG	CACTTCCGG
ZBTB7B	GCGACCACCGAA	TTCGGTGGTCGC
ZBTB7B_2	CGACCACCGA	TCGGTGGTCG
ZBTB7C	GCGACCACCGAA	TTCGGTGGTCGC
ZBTB7C_2	CGACCACC	GGTGGTCG
ZEB1	CCTCACCTG	CAGGTGAGG
ZEB1_2	CCCACCTGCGC	GCGCAGGTGGG
ZEB1_3	CACCTG	CAGGTG
ZFP1	CTTTTATACCCAGCT	AGCTGGGTATAAAAG
ZFP1_2	TTTTATACCCAGC	GCTGGGTATAAAA
ZFP14	GGAGGCACTGGAATG	CATTCCAGTGCCTCC
ZFP28	GATTTTCTATTTCTTCTTGA	TCAAGAAGAAATAGAAAATC
ZFP28_2	ATTTTCTATTTCTTCTTG	CAAGAAGAAATAGAAAAT
ZFP3	GCAAACTCCTACTC	GAGTAGGAGTTTGC
ZFP3_2	AAACTCCTACTC	GAGTAGGAGTTT
ZFP41	CGCTAACTCTCCGCA	TGCGGAGAGTTAGCG
ZFP41_2	GCTAACTCTCCGC	GCGGAGAGTTAGC
ZFP42	GTTCCAAAATGGCTGCCTCCG	CGGAGGCAGCCATTTTGGAAC
ZFP42_2	CAAAATGGCTGCC	GGCAGCCATTTTG
ZFP57	GCATTGCCGCAGT	ACTGCGGCAATGC
ZFP57_2	TGCCGCA	TGCGGCA
ZFP64	ACTGCACTCCAGCCTGGGCGACAG	CTGTCGCCCAGGCTGGAGTGCAGT
ZFP64_2	GGGCCCCGG	CCGGGGCCC
ZFP69	GTGGCTGGAAACAAGAT	ATCTTGTTTCCAGCCAC
ZFP69_2	GTGGCTGGAAACAAG	CTTGTTTCCAGCCAC
ZFP69B	GTGGCTGGA	TCCAGCCAC
ZFP82	GCTGAAGAGAGAATTAGTGAACTGGAAGA	TCTTCCAGTTCACTAATTCTCTCTTCAGC
ZIC1	GACCCCCCGCTGTG	CACAGCGGGGGGTC
ZIC3	GACCCCCCGCTGCGC	GCGCAGCGGGGGGTC
ZIC4	GACCCCCCGCTGTGC	GCACAGCGGGGGGTC
ZIC4_2	GACCCCCCGCTGTG	CACAGCGGGGGGTC
ZIC5	CGACCCCCCGCTGTGC	GCACAGCGGGGGGTCG
ZIC5_2	GACCCCCCGCTGTGC	GCACAGCGGGGGGTC
ZIK1	ATGGCAAAGGCACAACGAGAG	CTCTCGTTGTGCCTTTGCCAT
ZIK1_2	GGCAAAGGCACAACGA	TCGTTGTGCCTTTGCC
ZIM3	AGCAACAGAAACCTA	TAGGTTTCTGTTGCT
ZIM3_2	CAACAGAAACC	GGTTTCTGTTG
ZKSCAN1	ATAGTAGGTG	CACCTACTAT
ZKSCAN1_2	ATAGTAGGT	ACCTACTAT
ZKSCAN3	GGGCCCAGGCTAGCCCACGC	GCGTGGGCTAGCCTGGGCCC
ZKSCAN3_2	CCCAGGCTAGCCCA	TGGGCTAGCCTGGG
ZKSCAN5	GGAGGAGGTGAGAA	TTCTCACCTCCTCC
ZKSCAN5_2	GGAGGTGAG	CTCACCTCC
ZKSCAN8	CTGGCATACAGTAGGTGCTCAATA	TATTGAGCACCTACTGTATGCCAG
ZKSCAN8_2	GGCATACAGTAGGTGCTCAATA	TATTGAGCACCTACTGTATGCC
ZNF10	GACCCCTACCTCACACCATAT	ATATGGTGTGAGGTAGGGGTC
ZNF100	GCCGCCACCGTGTA	TACACGGTGGCGGC
ZNF100_2	CCATGGCGGCGGCGG	CCGCCGCCGCCATGG
ZNF100_3	CCGCCACCGTG	CACGGTGGCGG
ZNF100_4	CCATGGCGGCGGC	GCCGCCGCCATGG
ZNF101	ACACTGGGGCCA	TGGCCCCAGTGT
ZNF101_2	ACTGGGGC	GCCCCAGT
ZNF112	TCTGTGGTGTAAATACTCC	GGAGTATTTACACCACAGA
ZNF12	GGGGCTGCTTGTTATAGCATA	TATGCTATAACAAGCAGCCCC
ZNF12_2	GGGGCTGCTTGTTATAGCAT	ATGCTATAACAAGCAGCCCC
ZNF132	GGAGAGAGGGAAGGA	TCCTTCCCTCTCTCC
ZNF132_2	GGAGAGAGGGAAGG	CCTTCCCTCTCTCC
ZNF133	ATGTATAATTGGAG	CTCCAATTATACAT
ZNF133_2	GTATAATTGG	CCAATTATAC
ZNF134	GGCCTTCACCTGATTAGGTG	CACCTAATCAGGTGAAGGCC
ZNF134_2	CCTTCACCTGATTAG	CTAATCAGGTGAAGG
ZNF135	CCTCGACCTCCTGA	TCAGGAGGTCGAGG
ZNF136	GAATTCTTGGTTGAC	GTCAACCAAGAATTC
ZNF140	TAGGAGTGGAATTGCTGGGTC	GACCCAGCAATTCCACTCCTA
ZNF140_2	AGGAGTGGAATTGCTGGGT	ACCCAGCAATTCCACTCCT
ZNF141	GGGGGACGCCCCC	GGGGGCGTCCCCC
ZNF141_2	GGGGGACGCCC	GGGCGTCCCCC
ZNF143	TACCCACAATGCATTG	CAATGCATTGTGGGTA
ZNF146	GAATAGTATTCCATT	AATGGAATACTATTC
ZNF148	CCCCCCTCCCCC	GGGGGAGGGGGG
ZNF148_2	CCCCTCCCCC	GGGGGAGGGG
ZNF157	AGGCCAGCAATATACCTTTAC	GTAAAGGTATATTGCTGGCCT
ZNF16	AATAGGGAGCCATGGAAGGTTTT	AAAACCTTCCATGGCTCCCTATT
ZNF16_2	AATAGGGAGCCATGGAAGGTT	AACCTTCCATGGCTCCCTATT
ZNF174	GGCCGATCACTTGCCA	TGGCAAGTGATCGGCC
ZNF174_2	GCCGATCACTTGCC	GGCAAGTGATCGGC
ZNF175	ACAGGAAGT	ACTTCCTGT
ZNF177	CTCGATCGAAGGGCACAGTCATT	AATGACTGTGCCCTTCGATCGAG
ZNF177_2	TCGATCGAAGGGCACAGTCAT	ATGACTGTGCCCTTCGATCGA
ZNF18	GTGGTGTGAACTG	CAGTTCACACCAC
ZNF18_2	GGTGTGAAC	GTTCACACC
ZNF182	AAAAACAAAAGG	CCTTTTGTTTTT
ZNF184	TAGAAAGGTGCAT	ATGCACCTTTCTA
ZNF189	CATGCTGTTCCCT	AGGGAACAGCATG
ZNF189_2	TGCTGTTCC	GGAACAGCA
ZNF19	GGGGGGGGTAGGGGCCCTGACGGG	CCCGTCAGGGCCCCTACCCCCCCC
ZNF19_2	GGTAGGGGCCCTGACG	CGTCAGGGCCCCTACC
ZNF195	TTCTTGGCACCGTGCCAAGAA	TTCTTGGCACGGTGCCAAGAA
ZNF195_2	TTGGCACCGTGCCAAG	CTTGGCACGGTGCCAA
ZNF211	AATATATACCATATA	TATATGGTATATATT
ZNF211_2	TATATACCAT	ATGGTATATA
ZNF213	GCCCAGGCTGCG	CGCAGCCTGGGC
ZNF214	ATTCATCAAGGTCCT	AGGACCTTGATGAAT
ZNF214_2	TCATCAAGGTCCT	AGGACCTTGATGA
ZNF222	CGGCTCACATT	AATGTGAGCCG
ZNF222_2	GCTCACA	TGTGAGC
ZNF223	GGGGGTGCAGGCAGGG	CCCTGCCTGCACCCCC
ZNF223_2	GGGGGTGCAGGCAG	CTGCCTGCACCCCC
ZNF23	GGGTCGCGGCCATGGGTGA	TCACCCATGGCCGCGACCC
ZNF23_2	GGTCGCGGCCATGGGTG	CACCCATGGCCGCGACC
ZNF24	CATTCATTCATTC	GAATGAATGAATG
ZNF248	CTATCCATGAACATGGAATGTTTT	AAAACATTCCATGTTCATGGATAG
ZNF250	TAATCAAAACAGTA	TACTGTTTTGATTA
ZNF254	GCCTAGCCTCCCAGC	GCTGGGAGGCTAGGC
ZNF257	GAGAGGCAAGGG	CCCTTGCCTCTC
ZNF257_2	GAGGCAAGGG	CCCTTGCCTC
ZNF260	ACCATGGAATACTATGCAGCCA	TGGCTGCATAGTATTCCATGGT
ZNF263	GGAGGAGGAGGGGGAGGAGGA	TCCTCCTCCCCCTCCTCCTCC
ZNF263_2	GGGGGGAGGAGG	CCTCCTCCCCCC
ZNF263_3	GGGAGGA	TCCTCCC
ZNF264	GGGGCGGGG	CCCCGCCCC
ZNF264_2	GGCGGGG	CCCCGCC
ZNF266	ATTACTCACAGGCCC	GGGCCTGTGAGTAAT
ZNF266_2	ACTCACAGGCCC	GGGCCTGTGAGT
ZNF273	GCAGCTCCTGCC	GGCAGGAGCTGC
ZNF274	GGTATGAGTTCTCGCT	AGCGAGAACTCATACC
ZNF274_2	TATGAGTTCTCG	CGAGAACTCATA
ZNF276	GTTAAGGTAGTATAGTCCACCTTAA	TTAAGGTGGACTATACTACCTTAAC
ZNF276_2	TTAAGGTAGTATAGTCCACCTTA	TAAGGTGGACTATACTACCTTAA
ZNF28	GGCACCCCAC	GTGGGGTGCC
ZNF28_2	GCAGGTGGGGTGCCC	GGGCACCCCACCTGC
ZNF280D	ATGCAGCCATAAAA	TTTTATGGCTGCAT
ZNF281	GGGGGAGGGGAG	CTCCCCTCCCCC
ZNF281_2	GGGGGAGGGG	CCCCTCCCCC
ZNF282	CTTTCCCACAACACGAC	GTCGTGTTGTGGGAAAG
ZNF282_2	CTTTCCCACAACACG	CGTGTTGTGGGAAAG
ZNF284	GCTGAGGCAGGA	TCCTGCCTCAGC
ZNF296	TAGTGGACACT	AGTGTCCACTA
ZNF296_2	GTGGACA	TGTCCAC
ZNF30	AGCAGCC	GGCTGCT
ZNF304	CTCATCTGAAGGCTCGACTGGGGC	GCCCCAGTCGAGCCTTCAGATGAG
ZNF316	AAGTCAGCATTTTATT	AATAAAATGCTGACTT
ZNF316_2	GTCAGCATTTT	AAAATGCTGAC
ZNF317	TAACAGCAGACT	AGTCTGCTGTTA
ZNF317_2	ACAGCAGA	TCTGCTGT
ZNF32	ATGTAACCTGATACC	GGTATCAGGTTACAT
ZNF32_2	GTAACCTGATACC	GGTATCAGGTTAC
ZNF320	AGGGGGGCCCGGGGGCCTGTGCGAGGG	CCCTCGCACAGGCCCCCGGGCCCCCCT
ZNF320_2	GGGGGGCCCGGGGGCCTGTG	CACAGGCCCCCGGGCCCCCC
ZNF322	GTGCCTGCTACAGAG	CTCTGTAGCAGGCAC
ZNF322_2	GCCTGCTACAGAG	CTCTGTAGCAGGC
ZNF324	GCCAGGAAGACAAGGATGGTT	AACCATCCTTGTCTTCCTGGC
ZNF324_2	AGACAAGGATGGTT	AACCATCCTTGTCT
ZNF329	CCCCTGGATCCAGCCATGCCTGAA	TTCAGGCATGGCTGGATCCAGGGG
ZNF329_2	CCTGGATCCAGCCATGCCTGAA	TTCAGGCATGGCTGGATCCAGG
ZNF331	CCCTGCAGAGCCCT	AGGGCTCTGCAGGG
ZNF331_2	TGCAGAGCCC	GGGCTCTGCA
ZNF333	GTGGAGCCG	CGGCTCCAC
ZNF337	CTTGTCTGGGAA	TTCCCAGACAAG
ZNF337_2	TCTGGGAA	TTCCCAGA
ZNF33B	GGTATTGAATAG	CTATTCAATACC
ZNF33B_2	GGTATTGAA	TTCAATACC
ZNF341	GGGAACAGCCAC	GTGGCTGTTCCC
ZNF341_2	GAACAGCC	GGCTGTTC
ZNF343	CCGCTTCACCACGGCAC	GTGCCGTGGTGAAGCGG
ZNF343_2	CCGCTTCACCACGGCA	TGCCGTGGTGAAGCGG
ZNF345	TTGCAACATGGACAACCGTACC	GGTACGGTTGTCCATGTTGCAA
ZNF345_2	TTGCAACATGGACAACCGTAC	GTACGGTTGTCCATGTTGCAA
ZNF35	AATTCTA	TAGAATT
ZNF350	TAGGTCATAAAAGGAC	GTCCTTTTATGACCTA
ZNF350_2	GGTCATAAAAGG	CCTTTTATGACC
ZNF354A	ATAAATATAAATGGACTAATT	AATTAGTCCATTTATATTTAT
ZNF354A_2	TAAATATAAATGGACTAATT	AATTAGTCCATTTATATTTA
ZNF354C	ATCCAC	GTGGAT
ZNF366	TCCTCCTCC	GGAGGAGGA
ZNF37A	AGGGAGCCGGGGTA	TACCCCGGCTCCCT
ZNF37A_2	GGGAGCCGGGG	CCCCGGCTCCC
ZNF382	AGGGGACATCACTACAGATCCCAC	GTGGGATCTGTAGTGATGTCCCCT
ZNF384	TTTAAAAAAAAA	TTTTTTTTTAAA
ZNF384_2	AAAAAAAA	TTTTTTTT
ZNF385D	CCGTCGCGACGG	CCGTCGCGACGG
ZNF385D_2	GTCGCGACG	CGTCGCGAC
ZNF394	GCTTCTCC	GGAGAAGC
ZNF396	GTGTCCGAAAG	CTTTCGGACAC
ZNF396_2	GTGTCCGAAA	TTTCGGACAC
ZNF41	CACCATGAG	CTCATGGTG
ZNF410	TCCATCCCATAATACTC	GAGTATTATGGGATGGA
ZNF410_2	CCATCCCATAATACTC	GAGTATTATGGGATGG
ZNF416	TATCTGGGCAC	GTGCCCAGATA
ZNF416_2	TATCTGGGCA	TGCCCAGATA
ZNF417	CACATTGGGCGCCAA	TTGGCGCCCAATGTG
ZNF417_2	GGCGCCA	TGGCGCC
ZNF418	AAGAGGCTAAAAGCA	TGCTTTTAGCCTCTT
ZNF425	GGGAGGGCCCT	AGGGCCCTCCC
ZNF425_2	GAGGGCC	GGCCCTC
ZNF429	TAGGCATAGGCCGCAATGGGCTCA	TGAGCCCATTGCGGCCTATGCCTA
ZNF429_2	GGCATAGGCCGCAATGGGCT	AGCCCATTGCGGCCTATGCC
ZNF430	AGGCCTCACAATCATGGCAGAAGG	CCTTCTGCCATGATTGTGAGGCCT
ZNF433	GACTGCAGTAGTAAC	GTTACTACTGCAGTC
ZNF436	CACCTCCTCCAGGAAGCCTTCCCT	AGGGAAGGCTTCCTGGAGGAGGTG
ZNF436_2	CACCTCCTCCAGGAAGCCTTCC	GGAAGGCTTCCTGGAGGAGGTG
ZNF440	AGTGGTTCTGCT	AGCAGAACCACT
ZNF441	GAGACTCCGTCTC	GAGACGGAGTCTC
ZNF441_2	AGACTCCGTCTC	GAGACGGAGTCT
ZNF444	CCGTCCCCCTCCCCCC	GGGGGGAGGGGGACGG
ZNF444_2	CGTCCCCCTCCCCC	GGGGGAGGGGGACG
ZNF449	CCAAGCCCAACCAG	CTGGTTGGGCTTGG
ZNF449_2	AAGCCCAACC	GGTTGGGCTT
ZNF45	GCACCGGAAGTGACGCCG	CGGCGTCACTTCCGGTGC
ZNF45_2	CCGGAAGTG	CACTTCCGG
ZNF454	AGGCTCCGGGCCCCGGGG	CCCCGGGGCCCGGAGCCT
ZNF454_2	GGCTCCGGGCCCCGGGG	CCCCGGGGCCCGGAGCC
ZNF460	GCCTCAGCCTCCCGAG	CTCGGGAGGCTGAGGC
ZNF462	CCCAGCAGGAG	CTCCTGCTGGG
ZNF462_2	CAGCAGG	CCTGCTG
ZNF467	CCTCCCCTCCCCCCC	GGGGGGGAGGGGAGG
ZNF467_2	CCCCTCCCCC	GGGGGAGGGG
ZNF468	GCGCCCCCTCCCCC	GGGGGAGGGGGCGC
ZNF468_2	CCCCCTCCC	GGGAGGGGG
ZNF479	AGGGAAGACTTGG	CCAAGTCTTCCCT
ZNF479_2	GGAAGACTT	AAGTCTTCC
ZNF48	CTCCTCCAGGAAGCC	GGCTTCCTGGAGGAG
ZNF480	TACACATTCCTAAC	GTTAGGAATGTGTA
ZNF480_2	CACATTCCT	AGGAATGTG
ZNF483	CCTGCAGCTCCCTGC	GCAGGGAGCTGCAGG
ZNF483_2	CTGCAGCTCCCTG	CAGGGAGCTGCAG
ZNF484	AGGGGACAGAGGAACATG	CATGTTCCTCTGTCCCCT
ZNF485	AATAGAGATATACAG	CTGTATATCTCTATT
ZNF485_2	TAGAGATATAC	GTATATCTCTA
ZNF486	ATACTATGCAG	CTGCATAGTAT
ZNF490	GACAGCATATAG	CTATATGCTGTC
ZNF490_2	GACAGCATAT	ATATGCTGTC
ZNF491	TACTTGGCACAGTGCCAAGTA	TACTTGGCACTGTGCCAAGTA
ZNF491_2	CTTGGCACAGTGCCAAG	CTTGGCACTGTGCCAAG
ZNF492	AGAGCAACAAAAAGG	CCTTTTTGTTGCTCT
ZNF502	GCTAGGACCAGTGCAGTAGCCAAT	ATTGGCTACTGCACTGGTCCTAGC
ZNF502_2	GCTAGGACCAGTGCAGTAGCC	GGCTACTGCACTGGTCCTAGC
ZNF506	TGTGAGCCCCCACAC	GTGTGGGGGCTCACA
ZNF506_2	GAGCCCCCA	TGGGGGCTC
ZNF507	GGTCACATGACCC	GGGTCATGTGACC
ZNF507_2	GTCACATGAC	GTCATGTGAC
ZNF513	GGAGGAAGAG	CTCTTCCTCC
ZNF519	GCAGCTGCCCC	GGGGCAGCTGC
ZNF519_2	GCAGCTGCC	GGCAGCTGC
ZNF524	CTCGAACCC	GGGTTCGAG
ZNF525	AAATTGCTAATGAAGT	ACTTCATTAGCAATTT
ZNF527	GCCAGCAACAGAAACG	CGTTTCTGTTGCTGGC
ZNF527_2	GCCAGCAACAGAA	TTCTGTTGCTGGC
ZNF528	CCCAGGGAAGCCATTTC	GAAATGGCTTCCCTGGG
ZNF529	CCCTTCACCCAGCTTCCCCCAATG	CATTGGGGGAAGCTGGGTGAAGGG
ZNF530	GAAAGGAAAGGGGCGGGA	TCCCGCCCCTTTCCTTTC
ZNF530_2	GAAAGGAAAGGGGC	GCCCCTTTCCTTTC
ZNF534	GTTCTTGCCCCCC	GGGGGGCAAGAAC
ZNF534_2	TCTTGCCCC	GGGGCAAGA
ZNF540	GCAAACGTCCAC	GTGGACGTTTGC
ZNF540_2	AAACGTCCAC	GTGGACGTTT
ZNF543	GGGGAGGGGGCG	CGCCCCCTCCCC
ZNF544	TACTTGGCACAGTGCCAAGTA	TACTTGGCACTGTGCCAAGTA
ZNF544_2	TTGGCACAGTGCCAA	TTGGCACTGTGCCAA
ZNF547	TGCTAATGCAACA	TGTTGCATTAGCA
ZNF548	AACCCTGCTG	CAGCAGGGTT
ZNF548_2	CCCTGC	GCAGGG
ZNF549	GCTGCTGCCCAG	CTGGGCAGCAGC
ZNF549_2	TGCTGCCC	GGGCAGCA
ZNF554	CGGCAGAGCCG	CGGCTCTGCCG
ZNF554_2	GCAGAGC	GCTCTGC
ZNF558	ATTTGATGAAAGACATAAATCTACAGATC	GATCTGTAGATTTATGTCTTTCATCAAAT
ZNF560	GCCACTGCACTCCAGCCTGGGCGA	TCGCCCAGGCTGGAGTGCAGTGGC
ZNF565	GCCATGTTGTGAGGAAGCCCAAGC	GCTTGGGCTTCCTCACAACATGGC
ZNF566	GCGGCAAGGGAGGCGGGG	CCCCGCCTCCCTTGCCGC
ZNF566_2	GCGGCAAGGGAGGCGGG	CCCGCCTCCCTTGCCGC
ZNF567	ATAGAAGTAGACCCACAGA	TCTGTGGGTCTACTTCTAT
ZNF570	TACAAGAAAACTTT	AAAGTTTTCTTGTA
ZNF570_2	CAAGAAAACT	AGTTTTCTTG
ZNF571	CCGCGGCGGCGGCGG	CCGCCGCCGCCGCGG
ZNF571_2	GCGGCGGCGGCGG	CCGCCGCCGCCGC
ZNF573	CAGCCAAGGCACACACAGGAG	CTCCTGTGTGTGCCTTGGCTG
ZNF573_2	CAGCCAAGGCACACACAGG	CCTGTGTGTGCCTTGGCTG
ZNF574	GGGCTAGAGCGGCCC	GGGCCGCTCTAGCCC
ZNF574_2	GGCTAGAGCGGCCC	GGGCCGCTCTAGCC
ZNF577	CCTTAAGG	CCTTAAGG
ZNF580	CCTACCCTCACCTACCCT	AGGGTAGGTGAGGGTAGG
ZNF580_2	TGTTATGTTAAATAATTACCCTA	TAGGGTAATTATTTAACATAACA
ZNF580_3	GTTATGTTAAATAATTACC	GGTAATTATTTAACATAAC
ZNF582	TCTGTTACTTGCAGCCAAAAG	CTTTTGGCTGCAAGTAACAGA
ZNF582_2	TCTGTTACTTGCAGCCAAA	TTTGGCTGCAAGTAACAGA
ZNF585A	AAAAGAGAACAGA	TCTGTTCTCTTTT
ZNF585A_2	AAGAGAACAG	CTGTTCTCTT
ZNF585B	AGGAAAAAATGGTTTC	GAAACCATTTTTTCCT
ZNF585B_2	AGGAAAAAATGGTTT	AAACCATTTTTTCCT
ZNF586	ATGTGCTAATGCAGCAGG	CCTGCTGCATTAGCACAT
ZNF586_2	TGCTAATGCAGCA	TGCTGCATTAGCA
ZNF587	GCAGCTGGCGCCCAACATG	CATGTTGGGCGCCAGCTGC
ZNF587_2	TGGCGCCCAAC	GTTGGGCGCCA
ZNF594	GGGGTGAGAGCGGCT	AGCCGCTCTCACCCC
ZNF594_2	GTGAGAGCGGC	GCCGCTCTCAC
ZNF596	AGCGAGAGCGAGA	TCTCGCTCTCGCT
ZNF596_2	GCGAGAGCGAG	CTCGCTCTCGC
ZNF597	GGCCGCCATTTTGT	ACAAAATGGCGGCC
ZNF597_2	GCCGCCATTTTG	CAAAATGGCGGC
ZNF610	CCCGCCGCTCCCCC	GGGGGAGCGGCGGG
ZNF610_2	CCGCCGCTCC	GGAGCGGCGG
ZNF611	CGTAGGCTCTCCCC	GGGGAGAGCCTACG
ZNF611_2	TAGGCTCTCC	GGAGAGCCTA
ZNF614	TTAGATCAAGTA	TACTTGATCTAA
ZNF614_2	TTAGATCAAG	CTTGATCTAA
ZNF616	GGGTGAGCGTGA	TCACGCTCACCC
ZNF623	AAGTGCAAAGGCCCTGAGGCAG	CTGCCTCAGGGCCTTTGCACTT
ZNF623_2	GTGCAAAGGCCCTGAGGCAG	CTGCCTCAGGGCCTTTGCAC
ZNF627	GATCTCAACAAT	ATTGTTGAGATC
ZNF627_2	GATCTCAACA	TGTTGAGATC
ZNF629	CTCATCTGTAAAATGGGGA	TCCCCATTTTACAGATGAG
ZNF629_2	CTCATCTGTAAAATGGG	CCCATTTTACAGATGAG
ZNF652	GAAAGAGTTAAA	TTTAACTCTTTC
ZNF652_2	AAGAGTTAA	TTAACTCTT
ZNF660	ATTGATTACCCACCCTAC	GTAGGGTGGGTAATCAAT
ZNF660_2	TTGATTACCCACCCTA	TAGGGTGGGTAATCAA
ZNF662	GGTAGGAAGGGGCTAGAT	ATCTAGCCCCTTCCTACC
ZNF662_2	GGTAGGAAGGGGCTAGA	TCTAGCCCCTTCCTACC
ZNF664	TAGTAGGTGCTCAATAAATAT	ATATTTATTGAGCACCTACTA
ZNF664_2	TAGTAGGTGCTCAATAAAT	ATTTATTGAGCACCTACTA
ZNF667	TTAAGAGCTCAG	CTGAGCTCTTAA
ZNF667_2	TTAAGAGCTCA	TGAGCTCTTAA
ZNF669	GGGGCGATGACCACT	AGTGGTCATCGCCCC
ZNF671	GTTGAGTGGAGTGGA	TCCACTCCACTCAAC
ZNF671_2	GAGTGGAG	CTCCACTC
ZNF674	GGGGCAACAAAAGA	TCTTTTGTTGCCCC
ZNF674_2	GGGGCAACAAAA	TTTTGTTGCCCC
ZNF675	AGGACTAGGAGGACAAAATGT	ACATTTTGTCCTCCTAGTCCT
ZNF675_2	GGACTAGGAGGACAAAATG	CATTTTGTCCTCCTAGTCC
ZNF677	GATAAGAACAGC	GCTGTTCTTATC
ZNF680	GTCCAAGAAGAATGA	TCATTCTTCTTGGAC
ZNF680_2	CCAAGAAGAAT	ATTCTTCTTGG
ZNF681	GCCAAGGATGGGGA	TCCCCATCCTTGGC
ZNF681_2	CAAGGATG	CATCCTTG
ZNF682	CGGGCCAAGCCCCTAT	ATAGGGGCTTGGCCCG
ZNF682_2	GGCCAAGCCCC	GGGGCTTGGCC
ZNF684	ATACAGTCCACCCCTTTA	TAAAGGGGTGGACTGTAT
ZNF684_2	ACAGTCCACCCCTT	AAGGGGTGGACTGT
ZNF692	GGGGCCCACC	GGTGGGCCCC
ZNF692_2	GGGCCCAC	GTGGGCCC
ZNF7	CCAACACTTAC	GTAAGTGTTGG
ZNF7_2	AACACTT	AAGTGTT
ZNF701	GAGCACCAAAGGGGGGAAGGG	CCCTTCCCCCCTTTGGTGCTC
ZNF701_2	GAGCACCAAAGGGGGGA	TCCCCCCTTTGGTGCTC
ZNF704	CGCCGGCCGGCG	CGCCGGCCGGCG
ZNF704_2	GCCGGCCGGC	GCCGGCCGGC
ZNF707	CCCCACTCCTGGTAC	GTACCAGGAGTGGGG
ZNF708	CCGGCTGTGCCTCCT	AGGAGGCACAGCCGG
ZNF708_2	GCTGTGCCT	AGGCACAGC
ZNF713	TAGAAAAAAGACAGGAAAG	CTTTCCTGTCTTTTTTCTA
ZNF713_2	TCGACGACTGCCACGAAAG	CTTTCGTGGCAGTCGTCGA
ZNF713_3	AGAAAAAAGACAGGAAA	TTTCCTGTCTTTTTTCT
ZNF713_4	CGACGACTGCCACGAAA	TTTCGTGGCAGTCGTCG
ZNF714	GAGCAGCACTGC	GCAGTGCTGCTC
ZNF714_2	AGCAGCACTGC	GCAGTGCTGCT
ZNF716	AAGCAGGAAATAGTA	TACTATTTCCTGCTT
ZNF716_2	CAGGAAATA	TATTTCCTG
ZNF736	GGCCCAGGCCG	CGGCCTGGGCC
ZNF736_2	CCCAGGC	GCCTGGG
ZNF740	CCCCCCCCAC	GTGGGGGGGG
ZNF740_2	CCGCCCCCCCCAC	GTGGGGGGGGCGG
ZNF740_3	CCCCCCCCAC	GTGGGGGGGG
ZNF749	AACCCCGACCCCA	TGGGGTCGGGGTT
ZNF749_2	CCCCGACCCC	GGGGTCGGGG
ZNF750	GTCGCCTCAGGCC	GGCCTGAGGCGAC
ZNF750_2	GCCTCAGG	CCTGAGGC
ZNF75A	GCTTTTCCCACA	TGTGGGAAAAGC
ZNF75A_2	GCACCGGAAGTGACGCCG	CGGCGTCACTTCCGGTGC
ZNF75A_3	CCGGAAGTG	CACTTCCGG
ZNF75D	ATGTGGGAAA	TTTCCCACAT
ZNF75D_2	GTGGGAAAGCCT	AGGCTTTCCCAC
ZNF76	CCTACCCACAATGCACCGCGC	GCGCGGTGCATTGTGGGTAGG
ZNF76_2	ACCCACAATGCACCGCG	CGCGGTGCATTGTGGGT
ZNF765	GGGCGTAGCCAAGTAAA	TTTACTTGGCTACGCCC
ZNF765_2	GGGCGTAGCCAAG	CTTGGCTACGCCC
ZNF766	AAGAAACCT	AGGTTTCTT
ZNF768	TCGCTTACCCTCTCTGGG	CCCAGAGAGGGTAAGCGA
ZNF768_2	CCCTCTCTG	CAGAGAGGG
ZNF77	TCCCACTTCACCCTG	CAGGGTGAAGTGGGA
ZNF77_2	CCCACTTCACC	GGTGAAGTGGG
ZNF770	CGGCCTCA	TGAGGCCG
ZNF771	TGCGCTAACCATTGT	ACAATGGTTAGCGCA
ZNF771_2	GCGCTAACCATT	AATGGTTAGCGC
ZNF774	ACAGTGGACCACAAGCCGA	TCGGCTTGTGGTCCACTGT
ZNF774_2	AGTGGACCACAAGCC	GGCTTGTGGTCCACT
ZNF778	TTGGCCCCTCGTGCTGTG	CACAGCACGAGGGGCCAA
ZNF778_2	GGCCCCTCGTGCTG	CAGCACGAGGGGCC
ZNF780A	TGCCTGCCTG	CAGGCAGGCA
ZNF780A_2	TGCCTGCCT	AGGCAGGCA
ZNF781	TGAGACAGAGTC	GACTCTGTCTCA
ZNF781_2	TGAGACAGAGT	ACTCTGTCTCA
ZNF783	CCGCGGCCTCC	GGAGGCCGCGG
ZNF783_2	GCGGCCT	AGGCCGC
ZNF784	GTACCTACCGC	GCGGTAGGTAC
ZNF784_2	ACCTACCG	CGGTAGGT
ZNF786	CGCCCAGGCGG	CCGCCTGGGCG
ZNF786_2	CCCAGGC	GCCTGGG
ZNF787	GATGCACCTACCGTGCCTCG	CGAGGCACGGTAGGTGCATC
ZNF787_2	TGCCTCAGTTTACCC	GGGTAAACTGAGGCA
ZNF787_3	GATGCACCTACCGTGCCTC	GAGGCACGGTAGGTGCATC
ZNF787_4	TGCCTCAGTTTACC	GGTAAACTGAGGCA
ZNF789	TGCTCCCACTTCTGACACCAAA	TTTGGTGTCAGAAGTGGGAGCA
ZNF789_2	CTCCCACTTCTGACACCA	TGGTGTCAGAAGTGGGAG
ZNF79	GAAATTAATCTCTAA	TTAGAGATTAATTTC
ZNF79_2	AAATTAATCTCTAA	TTAGAGATTAATTT
ZNF791	GGGTTCCCTTGTATGTGATAA	TTATCACATACAAGGGAACCC
ZNF793	ACAGAGCCCCAAGCAG	CTGCTTGGGGCTCTGT
ZNF793_2	AGAGCCCCAAG	CTTGGGGCTCT
ZNF799	CAATGCCAACCCCCAA	TTGGGGGTTGGCATTG
ZNF799_2	GCCAACCCCC	GGGGGTTGGC
ZNF8	GTATGGATATACCACATTTT	AAAATGTGGTATATCCATAC
ZNF808	GGAGGTCTATAAACGG	CCGTTTATAGACCTCC
ZNF81	CTGGTACAACCACTATGGAAAACA	TGTTTTCCATAGTGGTTGTACCAG
ZNF816	AAATGGGGACATGCAGGG	CCCTGCATGTCCCCATTT
ZNF816_2	TGGGGACATGCAGGG	CCCTGCATGTCCCCA
ZNF821	CGGACAGACAGACAT	ATGTCTGTCTGTCCG
ZNF821_2	GGACAGACAGACA	TGTCTGTCTGTCC
ZNF823	AGAGACAGAGAA	TTCTCTGTCTCT
ZNF823_2	AGACAGAG	CTCTGTCT
ZNF84	TGTCTGTTCAT	ATGAACAGACA
ZNF846	GCTCCCGGGAGC	GCTCCCGGGAGC
ZNF846_2	TCCCGGGA	TCCCGGGA
ZNF85	AAAGAGATTACAGCAG	CTGCTGTAATCTCTTT
ZNF85_2	GAGATTACAGCA	TGCTGTAATCTC
ZNF860	CCGTTGCTCCCAGCT	AGCTGGGAGCAACGG
ZNF860_2	TGCTCCCA	TGGGAGCA
ZNF880	GCACTTTCCCAC	GTGGGAAAGTGC
ZNF880_2	GCACTTTCCC	GGGAAAGTGC
ZNF891	GCTCGCAGGCTTCTAGCC	GGCTAGAAGCCTGCGAGC
ZNF891_2	GGCTTCTAGCC	GGCTAGAAGCC
ZNF92	GTAAAATGGGCA	TGCCCATTTTAC
ZNF92_2	AAAATGGG	CCCATTTT
ZNF93	GGCAGCGGCAGCGGCG	CGCCGCTGCCGCTGCC
ZNF93_2	GGCAGCGGCAGCGG	CCGCTGCCGCTGCC
ZNF98	AGGACAACAAAAAGGCAATGT	ACATTGCCTTTTTGTTGTCCT
ZNF98_2	AGGACAACAAAAAGGCA	TGCCTTTTTGTTGTCCT
ZSCAN1	ATGCACACACTGAAAAA	TTTTTCAGTGTGTGCAT
ZSCAN1_2	GCACACACTGAAAA	TTTTCAGTGTGTGC
ZSCAN16	AAGTGTTAACAGAGCCTC	GAGGCTCTGTTAACACTT
ZSCAN20	AAACTCCAGAAAA	TTTTCTGGAGTTT
ZSCAN20_2	TCCAGAA	TTCTGGA
ZSCAN21	AAGCACT	AGTGCTT
ZSCAN22	GTCCGAGGGCGGAGGCGG	CCGCCTCCGCCCTCGGAC
ZSCAN22_2	CCGAGGGCGGAGGC	GCCTCCGCCCTCGG
ZSCAN23	CTCATGTGCTAATTACAAA	TTTGTAATTAGCACATGAG
ZSCAN23_2	TCATGTGCTAATTACAA	TTGTAATTAGCACATGA
ZSCAN29	CGTCTACACGGG	CCCGTGTAGACG
ZSCAN29_2	CGTCTACACGG	CCGTGTAGACG
ZSCAN31	GCATAACTGCCCTGCGTCC	GGACGCAGGGCAGTTATGC
ZSCAN31_2	GCATAACTGCCCTGCGTC	GACGCAGGGCAGTTATGC
ZSCAN4	TGCACACACTGAAAA	TTTTCAGTGTGTGCA
ZSCAN5A	CTGTCCCCCCCCAAATCC	GGATTTGGGGGGGGACAG
ZSCAN5A_2	GTCCCCCCCCAAA	TTTGGGGGGGGAC
ZSCAN9	AAGGATAAGATAAGAATCAC	GTGATTCTTATCTTATCCTT
ZSCAN9_2	AGGATAAGATAAGAATCA	TGATTCTTATCTTATCCT
